zipcode,county_fips,county,sqmi,completed_trips,unaccepted_requests,total_requests,Uber_completed_trips,Uber_unaccepted_requests,Uber_total_requests,Uber_share_completed,Uber_perfect,Lyft_completed_trips,Lyft_unaccepted_requests,Lyft_total_requests,Lyft_share_completed,Lyft_perfect
97635,49,Modoc,52.14797777,0,0,0,0,0,0,0,0,0,0,0,0,0
96101,49,Modoc,596.555109,0,0,0,0,0,0,0,0,0,0,0,0,0
96116,49,Modoc,176.4636429,0,0,0,0,0,0,0,0,0,0,0,0,0
96054,49,Modoc,117.7880255,0,0,0,0,0,0,0,0,0,0,0,0,0
96104,49,Modoc,238.1035859,0,0,0,0,0,0,0,0,0,0,0,0,0
96108,49,Modoc,187.4188132,0,0,0,0,0,0,0,0,0,0,0,0,0
96110,49,Modoc,117.945576,0,0,0,0,0,0,0,0,0,0,0,0,0
96112,49,Modoc,127.5939073,0,0,0,0,0,0,0,0,0,0,0,0,0
96115,49,Modoc,111.9517152,0,0,0,0,0,0,0,0,0,0,0,0,0
96134,49,Modoc,329.4823287,0,0,0,0,0,0,0,0,0,0,0,0,0
96015,49,Modoc,234.1568099,0,0,0,0,0,0,0,0,0,0,0,0,0
95641,67,Sacramento,41.98388058,162,16,178,38,16,54,0.703703704,0,124,0,124,1,1
95680,67,Sacramento,2.328753927,12,2,14,9,2,11,0.818181818,0,3,0,3,1,1
95818,67,Sacramento,3.859370492,203182,1612,204794,84520,1612,86132,0.98128454,0,118662,0,118662,1,1
95822,67,Sacramento,8.39759458,172966,1725,174691,67615,1725,69340,0.975122584,0,105351,0,105351,1,1
95838,67,Sacramento,9.20512817,127027,1526,128553,44438,1526,45964,0.966800104,0,82589,0,82589,1,1
95843,67,Sacramento,6.516908258,79645,1004,80649,32086,1004,33090,0.969658507,0,47559,0,47559,1,1
95693,67,Sacramento,58.6617107,1345,70,1415,742,70,812,0.913793103,0,603,0,603,1,1
95864,67,Sacramento,6.279926455,82107,978,83085,39654,978,40632,0.975930301,0,42453,0,42453,1,1
95670,67,Sacramento,12.91739262,209069,2700,211769,84649,2700,87349,0.969089514,0,124420,0,124420,1,1
95742,67,Sacramento,50.44221281,58627,816,59443,27651,816,28467,0.97133523,0,30976,0,30976,1,1
95632,67,Sacramento,113.2610026,10439,397,10836,4737,397,5134,0.92267238,0,5702,0,5702,1,1
95816,67,Sacramento,2.728551958,359819,3826,363645,151701,3826,155527,0.97539977,0,208118,0,208118,1,1
95833,67,Sacramento,8.088770391,216935,2619,219554,96003,2619,98622,0.973444059,0,120932,0,120932,1,1
95610,67,Sacramento,7.928290479,146475,2028,148503,62980,2028,65008,0.96880384,0,83495,0,83495,1,1
95624,67,Sacramento,45.55272822,129891,1778,131669,55913,1778,57691,0.969180635,0,73978,0,73978,1,1
95811,67,Sacramento,2.316292804,389097,5617,394714,175899,5617,181516,0.96905507,0,213198,0,213198,1,1
95630,67,Sacramento,26.19203422,211794,3629,215423,103299,3629,106928,0.966061275,0,108495,0,108495,1,1
95660,67,Sacramento,6.354710954,119703,1507,121210,43504,1507,45011,0.966519295,0,76199,0,76199,1,1
95828,67,Sacramento,12.40300778,178362,1810,180172,63847,1810,65657,0.97243249,0,114515,0,114515,1,1
95638,67,Sacramento,80.22724741,184,9,193,98,9,107,0.91588785,0,86,0,86,1,1
95819,67,Sacramento,3.606194712,147840,1254,149094,62155,1254,63409,0.980223628,0,85685,0,85685,1,1
95820,67,Sacramento,5.267352295,169519,1573,171092,64743,1573,66316,0.976280234,0,104776,0,104776,1,1
95821,67,Sacramento,7.061906519,193687,2527,196214,76003,2527,78530,0.967821215,0,117684,0,117684,1,1
95608,67,Sacramento,13.2280844,201541,2635,204176,84662,2635,87297,0.969815687,0,116879,0,116879,1,1
95615,67,Sacramento,21.15594553,69,2,71,17,2,19,0.894736842,0,52,0,52,1,1
95626,67,Sacramento,37.69843304,5662,92,5754,2539,92,2631,0.965032307,0,3123,0,3123,1,1
95628,67,Sacramento,12.8916306,103829,1459,105288,48939,1459,50398,0.971050439,0,54890,0,54890,1,1
95639,67,Sacramento,4.633485616,294,3,297,150,3,153,0.980392157,0,144,0,144,1,1
95662,67,Sacramento,10.80647398,64282,1014,65296,28366,1014,29380,0.965486726,0,35916,0,35916,1,1
95690,67,Sacramento,51.59436591,239,33,272,118,33,151,0.781456954,0,121,0,121,1,1
95652,67,Sacramento,3.736907159,19305,205,19510,8558,205,8763,0.976606185,0,10747,0,10747,1,1
95655,67,Sacramento,9.528778755,14916,263,15179,6975,263,7238,0.963663996,0,7941,0,7941,1,1
95673,67,Sacramento,16.25343147,23738,366,24104,10391,366,10757,0.965975644,0,13347,0,13347,1,1
95683,67,Sacramento,86.36109331,993,66,1059,585,66,651,0.898617512,0,408,0,408,1,1
95815,67,Sacramento,7.653088233,247715,2529,250244,100835,2529,103364,0.975533068,0,146880,0,146880,1,1
95823,67,Sacramento,11.47894296,376177,4140,380317,126815,4140,130955,0.968386087,0,249362,0,249362,1,1
95827,67,Sacramento,8.945189777,80609,1122,81731,30303,1122,31425,0.964295943,0,50306,0,50306,1,1
95832,67,Sacramento,8.310720776,40027,443,40470,13308,443,13751,0.967784161,0,26719,0,26719,1,1
95837,67,Sacramento,14.37718303,380852,4910,385762,222071,4910,226981,0.978368233,0,158781,0,158781,1,1
95757,67,Sacramento,64.49736264,80979,853,81832,29715,853,30568,0.972095001,0,51264,0,51264,1,1
95621,67,Sacramento,6.67541402,125423,1700,127123,52164,1700,53864,0.968439032,0,73259,0,73259,1,1
95758,67,Sacramento,13.6237986,171543,1756,173299,68599,1756,70355,0.975040864,0,102944,0,102944,1,1
95814,67,Sacramento,1.396345011,687116,10436,697552,337067,10436,347503,0.969968605,0,350049,0,350049,1,1
95817,67,Sacramento,2.264911231,153769,1137,154906,57740,1137,58877,0.980688554,0,96029,0,96029,1,1
95824,67,Sacramento,3.987875582,105938,1140,107078,36701,1140,37841,0.969873946,0,69237,0,69237,1,1
95825,67,Sacramento,4.655614013,322863,3346,326209,123069,3346,126415,0.973531622,0,199794,0,199794,1,1
95826,67,Sacramento,10.53782084,219005,2422,221427,88176,2422,90598,0.973266518,0,130829,0,130829,1,1
95829,67,Sacramento,20.30827217,50776,616,51392,20711,616,21327,0.971116425,0,30065,0,30065,1,1
95830,67,Sacramento,13.01255917,985,6,991,450,6,456,0.986842105,0,535,0,535,1,1
95831,67,Sacramento,6.995148352,111184,1471,112655,44301,1471,45772,0.967862449,0,66883,0,66883,1,1
95834,67,Sacramento,9.964077897,209193,2474,211667,91918,2474,94392,0.973790152,0,117275,0,117275,1,1
95835,67,Sacramento,8.879452855,124035,1504,125539,58805,1504,60309,0.975061765,0,65230,0,65230,1,1
95841,67,Sacramento,3.897765454,114136,1431,115567,44907,1431,46338,0.969118218,0,69229,0,69229,1,1
95842,67,Sacramento,3.971758053,103751,1384,105135,39119,1384,40503,0.965829692,0,64632,0,64632,1,1
95671,67,Sacramento,1.476818754,0,0,0,0,0,0,0,0,0,0,0,0,0
95919,115,Yuba,26.78775304,1,0,1,1,0,1,1,1,0,0,0,0,0
95922,115,Yuba,51.88119452,0,0,0,0,0,0,0,0,0,0,0,0,0
95935,115,Yuba,25.81079042,0,0,0,0,0,0,0,0,0,0,0,0,0
95692,115,Yuba,57.2241151,4508,283,4791,2639,283,2922,0.903148528,0,1869,0,1869,1,1
95903,115,Yuba,20.44254102,73,13,86,46,13,59,0.779661017,0,27,0,27,1,1
95918,115,Yuba,55.6878703,17,8,25,12,8,20,0.6,0,5,0,5,1,1
95901,115,Yuba,200.1995575,24429,812,25241,14166,812,14978,0.945787154,0,10263,0,10263,1,1
95977,115,Yuba,37.66085817,10,2,12,8,2,10,0.8,0,2,0,2,1,1
95925,115,Yuba,35.27988289,0,0,0,0,0,0,0,0,0,0,0,0,0
95961,115,Yuba,45.84781019,8270,243,8513,4572,243,4815,0.94953271,0,3698,0,3698,1,1
95962,115,Yuba,37.9506146,0,0,0,0,0,0,0,0,0,0,0,0,0
95920,21,Glenn,69.07903811,0,0,0,0,0,0,0,0,0,0,0,0,0
95943,21,Glenn,63.5875412,1,0,1,0,0,0,0,0,1,0,1,1,1
95963,21,Glenn,325.3486672,91,10,101,53,10,63,0.841269841,0,38,0,38,1,1
95939,21,Glenn,257.0438268,0,0,0,0,0,0,0,0,0,0,0,0,0
95951,21,Glenn,19.56917128,81,3,84,31,3,34,0.911764706,0,50,0,50,1,1
95988,21,Glenn,328.629714,14,1,15,8,1,9,0.888888889,0,6,0,6,1,1
95913,21,Glenn,17.35786635,0,0,0,0,0,0,0,0,0,0,0,0,0
95930,7,Butte,7.508228933,0,0,0,0,0,0,0,0,0,0,0,0,0
95973,7,Butte,300.1031749,53408,936,54344,37422,936,38358,0.975598311,0,15986,0,15986,1,1
95914,7,Butte,21.88921316,0,0,0,0,0,0,0,0,0,0,0,0,0
95942,7,Butte,69.15221989,0,1,1,0,1,1,0,0,0,0,0,0,0
95948,7,Butte,75.56635033,446,21,467,191,21,212,0.900943396,0,255,0,255,1,1
95966,7,Butte,170.1551517,943,88,1031,525,88,613,0.856443719,0,418,0,418,1,1
95969,7,Butte,50.69911758,165,12,177,89,12,101,0.881188119,0,76,0,76,1,1
95917,7,Butte,80.7030369,31,3,34,24,3,27,0.888888889,0,7,0,7,1,1
95972,7,Butte,1.083977932,0,0,0,0,0,0,0,0,0,0,0,0,0
95916,7,Butte,84.67447101,1,0,1,1,0,1,1,1,0,0,0,0,0
95941,7,Butte,35.43432568,0,0,0,0,0,0,0,0,0,0,0,0,0
95926,7,Butte,7.778324952,158633,2180,160813,107086,2180,109266,0.980048689,0,51547,0,51547,1,1
95928,7,Butte,145.3919241,215905,4411,220316,153828,4411,158239,0.972124445,0,62077,0,62077,1,1
95938,7,Butte,68.14946551,1012,36,1048,717,36,753,0.952191235,0,295,0,295,1,1
95954,7,Butte,126.8314876,18,0,18,10,0,10,1,1,8,0,8,1,1
95965,7,Butte,311.4260256,1404,101,1505,806,101,907,0.888643881,0,598,0,598,1,1
95968,7,Butte,1.798341519,31,1,32,21,1,22,0.954545455,0,10,0,10,1,1
95974,7,Butte,0.41681248,0,0,0,0,0,0,0,0,0,0,0,0,0
95978,7,Butte,0.037166765,0,0,0,0,0,0,0,0,0,0,0,0,0
95958,7,Butte,6.651737732,0,0,0,0,0,0,0,0,0,0,0,0,0
95929,7,Butte,0.007832893,0,0,0,0,0,0,0,0,0,0,0,0,0
95957,101,Sutter,93.00104097,9,2,11,9,2,11,0.818181818,0,0,0,0,0,0
95953,101,Sutter,116.1580697,1000,45,1045,626,45,671,0.932935917,0,374,0,374,1,1
95991,101,Sutter,41.1199395,34741,885,35626,21384,885,22269,0.960258656,0,13357,0,13357,1,1
95982,101,Sutter,42.57486191,371,21,392,242,21,263,0.920152091,0,129,0,129,1,1
95659,101,Sutter,45.92801405,342,15,357,175,15,190,0.921052632,0,167,0,167,1,1
95674,101,Sutter,31.86233477,103,3,106,66,3,69,0.956521739,0,37,0,37,1,1
95645,101,Sutter,123.8026115,266,13,279,73,13,86,0.848837209,0,193,0,193,1,1
95668,101,Sutter,64.98078888,429,20,449,265,20,285,0.929824561,0,164,0,164,1,1
95993,101,Sutter,84.28212903,23093,560,23653,13870,560,14430,0.961191961,0,9223,0,9223,1,1
95676,101,Sutter,1.263095475,0,0,0,0,0,0,0,0,0,0,0,0,0
96051,89,Shasta,343.4339718,11,1,12,7,1,8,0.875,0,4,0,4,1,1
96084,89,Shasta,54.26261613,1,0,1,0,0,0,0,0,1,0,1,1,1
96003,89,Shasta,111.1520516,59991,1005,60996,42846,1005,43851,0.97708148,0,17145,0,17145,1,1
96065,89,Shasta,137.0729844,0,0,0,0,0,0,0,0,0,0,0,0,0
96088,89,Shasta,173.0170837,11,1,12,10,1,11,0.909090909,0,1,0,1,1,1
96013,89,Shasta,153.4093865,0,0,0,0,0,0,0,0,0,0,0,0,0
96002,89,Shasta,30.5677278,65162,1473,66635,47389,1473,48862,0.969853874,0,17773,0,17773,1,1
96001,89,Shasta,72.40625139,64975,1722,66697,46867,1722,48589,0.96455988,0,18108,0,18108,1,1
96071,89,Shasta,25.78441797,0,0,0,0,0,0,0,0,0,0,0,0,0
96011,89,Shasta,116.0101899,0,0,0,0,0,0,0,0,0,0,0,0,0
96096,89,Shasta,103.6055968,0,0,0,0,0,0,0,0,0,0,0,0,0
96069,89,Shasta,92.86509836,3,1,4,3,1,4,0.75,0,0,0,0,0,0
96076,89,Shasta,221.3709641,0,0,0,0,0,0,0,0,0,0,0,0,0
96087,89,Shasta,42.71852429,66,4,70,53,4,57,0.929824561,0,13,0,13,1,1
96019,89,Shasta,19.31834417,4507,116,4623,3068,116,3184,0.963567839,0,1439,0,1439,1,1
96028,89,Shasta,168.1863112,0,0,0,0,0,0,0,0,0,0,0,0,0
96033,89,Shasta,144.7484647,1,0,1,1,0,1,1,1,0,0,0,0,0
96047,89,Shasta,248.2862196,13,0,13,10,0,10,1,1,3,0,3,1,1
96073,89,Shasta,45.22651854,918,42,960,684,42,726,0.94214876,0,234,0,234,1,1
96017,89,Shasta,93.40496259,1,0,1,1,0,1,1,1,0,0,0,0,0
96007,89,Shasta,122.4799641,9033,355,9388,6228,355,6583,0.946073219,0,2805,0,2805,1,1
96008,89,Shasta,61.81226515,70,1,71,57,1,58,0.982758621,0,13,0,13,1,1
96016,89,Shasta,42.68848886,0,0,0,0,0,0,0,0,0,0,0,0,0
96040,89,Shasta,51.50690407,0,0,0,0,0,0,0,0,0,0,0,0,0
96062,89,Shasta,67.12322481,43,3,46,40,3,43,0.930232558,0,3,0,3,1,1
96140,61,Placer,10.34394099,2625,110,2735,1810,110,1920,0.942708333,0,815,0,815,1,1
95648,61,Placer,144.2985129,69568,1566,71134,33961,1566,35527,0.955920849,0,35607,0,35607,1,1
96148,61,Placer,2.089251251,1206,46,1252,824,46,870,0.947126437,0,382,0,382,1,1
96143,61,Placer,9.229165851,4974,252,5226,3488,252,3740,0.932620321,0,1486,0,1486,1,1
95703,61,Placer,8.877611525,260,8,268,109,8,117,0.931623932,0,151,0,151,1,1
95663,61,Placer,8.701006747,4022,189,4211,2526,189,2715,0.93038674,0,1496,0,1496,1,1
95713,61,Placer,60.77073512,641,89,730,421,89,510,0.825490196,0,220,0,220,1,1
95658,61,Placer,23.30401433,3285,98,3383,1779,98,1877,0.947789025,0,1506,0,1506,1,1
95681,61,Placer,15.61204812,241,15,256,131,15,146,0.897260274,0,110,0,110,1,1
96145,61,Placer,17.71000254,8388,388,8776,5911,388,6299,0.938402921,0,2477,0,2477,1,1
95603,61,Placer,35.76382188,24818,962,25780,13391,962,14353,0.932975685,0,11427,0,11427,1,1
95604,61,Placer,0.049917466,141,8,149,109,8,117,0.931623932,0,32,0,32,1,1
95677,61,Placer,9.724166337,79952,1157,81109,41410,1157,42567,0.97281932,0,38542,0,38542,1,1
95714,61,Placer,3.596169134,2,0,2,1,0,1,1,1,1,0,1,1,1
95717,61,Placer,19.50483206,1,1,2,1,1,2,0.5,0,0,0,0,0,0
95678,61,Placer,11.42496098,206725,3193,209918,102892,3193,106085,0.969901494,0,103833,0,103833,1,1
95650,61,Placer,22.87474574,17943,403,18346,9436,403,9839,0.959040553,0,8507,0,8507,1,1
95661,61,Placer,8.954252026,168418,2249,170667,76793,2249,79042,0.971546773,0,91625,0,91625,1,1
95701,61,Placer,31.75260708,9,1,10,7,1,8,0.875,0,2,0,2,1,1
95715,61,Placer,33.81747238,14,0,14,13,0,13,1,1,1,0,1,1,1
95722,61,Placer,10.44193189,396,17,413,190,17,207,0.917874396,0,206,0,206,1,1
95747,61,Placer,42.11455403,95992,1344,97336,49815,1344,51159,0.973728963,0,46177,0,46177,1,1
95728,61,Placer,27.99242557,263,25,288,162,25,187,0.86631016,0,101,0,101,1,1
95736,61,Placer,0.231224219,182,5,187,25,5,30,0.833333333,0,157,0,157,1,1
95746,61,Placer,18.4001103,29827,580,30407,16890,580,17470,0.966800229,0,12937,0,12937,1,1
95631,61,Placer,173.9820558,75,6,81,45,6,51,0.882352941,0,30,0,30,1,1
95602,61,Placer,49.66491541,6474,267,6741,3313,267,3580,0.925418994,0,3161,0,3161,1,1
95765,61,Placer,12.52246877,69321,965,70286,36178,965,37143,0.974019331,0,33143,0,33143,1,1
96141,61,Placer,28.86647408,943,79,1022,675,79,754,0.895225464,0,268,0,268,1,1
96146,61,Placer,40.43022325,4476,201,4677,3109,201,3310,0.939274924,0,1367,0,1367,1,1
90005,37,Los Angeles,1.179838308,904540,28078,932618,563615,11018,574633,0.980826023,0,340925,17060,357985,0.952344372,0
90027,37,Los Angeles,8.12483174,1269451,46407,1315858,738555,14340,752895,0.980953519,0,530896,32067,562963,0.943038885,0
90039,37,Los Angeles,3.639784995,538949,18085,557034,309433,4970,314403,0.984192263,0,229516,13115,242631,0.945946726,0
90040,37,Los Angeles,5.568238183,302635,13496,316131,199096,6062,205158,0.970452042,0,103539,7434,110973,0.933010732,0
90056,37,Los Angeles,2.257640892,106814,4956,111770,64649,1599,66248,0.975863422,0,42165,3357,45522,0.926255437,0
90278,37,Los Angeles,3.670979116,336375,10919,347294,214443,3385,217828,0.984460216,0,121932,7534,129466,0.941807115,0
90650,37,Los Angeles,9.902544877,509637,19608,529245,307076,6395,313471,0.979599389,0,202561,13213,215774,0.938764633,0
90815,37,Los Angeles,7.054004899,345945,12010,357955,211383,4153,215536,0.980731757,0,134562,7857,142419,0.944831799,0
91301,37,Los Angeles,33.11738345,90218,5112,95330,59867,1643,61510,0.973288896,0,30351,3469,33820,0.897427558,0
91352,37,Los Angeles,11.60036111,318918,11220,330138,194319,3992,198311,0.979870002,0,124599,7228,131827,0.945170564,0
91423,37,Los Angeles,4.062187103,471867,15874,487741,293089,5926,299015,0.980181596,0,178778,9948,188726,0.947288662,0
91731,37,Los Angeles,3.795490345,235633,8860,244493,149352,3988,153340,0.973992435,0,86281,4872,91153,0.946551403,0
91754,37,Los Angeles,4.519598427,287670,9178,296848,193406,4075,197481,0.979365103,0,94264,5103,99367,0.948644922,0
91791,37,Los Angeles,6.642211772,172284,6243,178527,100586,2358,102944,0.977094343,0,71698,3885,75583,0.948599553,0
93532,37,Los Angeles,122.0283224,176,20,196,135,12,147,0.918367347,0,41,8,49,0.836734694,0
90001,37,Los Angeles,3.280115919,476421,17534,493955,281279,5738,287017,0.980008153,0,195142,11796,206938,0.94299742,0
90002,37,Los Angeles,2.99256066,339115,14199,353314,186128,3942,190070,0.979260273,0,152987,10257,163244,0.937167675,0
90058,37,Los Angeles,5.786403203,241741,10311,252052,147180,3340,150520,0.977810258,0,94561,6971,101532,0.931341843,0
90068,37,Los Angeles,8.003776528,735926,38983,774909,455984,13043,469027,0.972191366,0,279942,25940,305882,0.915196056,0
90242,37,Los Angeles,4.516104957,314447,11473,325920,192993,4411,197404,0.977654961,0,121454,7062,128516,0.945049644,0
90248,37,Los Angeles,4.752625751,194707,7335,202042,119759,2602,122361,0.978735054,0,74948,4733,79681,0.940600645,0
90262,37,Los Angeles,4.772185398,403239,16422,419661,238300,5342,243642,0.978074388,0,164939,11080,176019,0.93705225,0
90605,37,Los Angeles,6.38638616,167588,6050,173638,106021,2358,108379,0.978243018,0,61567,3692,65259,0.943425428,0
90807,37,Los Angeles,4.420872772,409675,11511,421186,248211,4208,252419,0.983329306,0,161464,7303,168767,0.956727322,0
91001,37,Los Angeles,8.260058516,156808,6540,163348,89940,1851,91791,0.979834624,0,66868,4689,71557,0.93447182,0
91030,37,Los Angeles,3.431552116,167912,5695,173607,100033,1796,101829,0.982362588,0,67879,3899,71778,0.945679735,0
91311,37,Los Angeles,32.56457546,242011,8122,250133,153842,3191,157033,0.97967943,0,88169,4931,93100,0.947035446,0
91384,37,Los Angeles,103.601118,28668,1806,30474,19093,579,19672,0.970567304,0,9575,1227,10802,0.886409924,0
91505,37,Los Angeles,5.353635359,1016588,30136,1046724,623059,9905,632964,0.984351401,0,393529,20231,413760,0.951104505,0
91711,37,Los Angeles,14.93616752,192038,6400,198438,112086,1991,114077,0.982546876,0,79952,4409,84361,0.947736513,0
91765,37,Los Angeles,18.57305905,100859,4508,105367,65400,1283,66683,0.980759714,0,35459,3225,38684,0.916632199,0
90007,37,Los Angeles,2.430144085,2144584,73914,2218498,852592,17391,869983,0.980009954,0,1291992,56523,1348515,0.958085005,0
90016,37,Los Angeles,3.597015088,703407,30391,733798,422243,8970,431213,0.979198215,0,281164,21421,302585,0.929206669,0
90064,37,Los Angeles,3.724477697,677360,20089,697449,474565,7413,481978,0.98461963,0,202795,12676,215471,0.941170738,0
90077,37,Los Angeles,7.261682174,100689,7474,108163,71078,2425,73503,0.967008149,0,29611,5049,34660,0.854327755,0
90210,37,Los Angeles,10.74274056,811575,33137,844712,565445,13833,579278,0.976120274,0,246130,19304,265434,0.927273823,0
90501,37,Los Angeles,5.685057061,336863,10822,347685,213418,3764,217182,0.982668914,0,123445,7058,130503,0.945916952,0
90802,37,Los Angeles,6.530832715,901406,37806,939212,522217,13670,535887,0.974490891,0,379189,24136,403325,0.940157441,0
91007,37,Los Angeles,5.505432949,210570,7141,217711,133148,3197,136345,0.976552129,0,77422,3944,81366,0.951527665,0
91040,37,Los Angeles,8.320091136,59168,2911,62079,38991,1047,40038,0.973849843,0,20177,1864,22041,0.915430334,0
91302,37,Los Angeles,27.44995667,121929,7110,129039,83900,2364,86264,0.972595753,0,38029,4746,42775,0.889047341,0
91354,37,Los Angeles,7.327233766,60693,2036,62729,38390,734,39124,0.981239137,0,22303,1302,23605,0.944842194,0
90012,37,Los Angeles,3.637940576,1602196,60819,1663015,980471,27784,1008255,0.972443479,0,621725,33035,654760,0.949546399,0
90045,37,Los Angeles,10.75915461,4801585,167935,4969520,3050553,73664,3124217,0.976421612,0,1751032,94271,1845303,0.948912997,0
90047,37,Los Angeles,4.706725699,528272,21712,549984,286217,6568,292785,0.977567157,0,242055,15144,257199,0.941119522,0
90063,37,Los Angeles,3.284827547,409117,14172,423289,253219,4918,258137,0.980948101,0,155898,9254,165152,0.94396677,0
90066,37,Los Angeles,4.80843671,880980,28685,909665,572953,8895,581848,0.984712502,0,308027,19790,327817,0.939630953,0
90220,37,Los Angeles,6.91754066,367250,15876,383126,204437,4698,209135,0.977536041,0,162813,11178,173991,0.935755298,0
90232,37,Los Angeles,2.162533418,545557,19861,565418,346411,6177,352588,0.982480969,0,199146,13684,212830,0.935704553,0
90602,37,Los Angeles,3.75138529,137626,4904,142530,84711,1739,86450,0.979884326,0,52915,3165,56080,0.943562767,0
90806,37,Los Angeles,4.886645566,355449,13616,369065,201296,4508,205804,0.978095664,0,154153,9108,163261,0.944212029,0
91206,37,Los Angeles,5.763638893,283530,9674,293204,182642,3802,186444,0.979607818,0,100888,5872,106760,0.944998127,0
91331,37,Los Angeles,9.344694755,431651,14913,446564,260747,5130,265877,0.980705364,0,170904,9783,180687,0.945856647,0
91702,37,Los Angeles,65.03182489,268553,9974,278527,155581,3326,158907,0.979069519,0,112972,6648,119620,0.944424009,0
91604,37,Los Angeles,4.74040131,655248,22044,677292,414306,8344,422650,0.980257897,0,240942,13700,254642,0.946198977,0
91723,37,Los Angeles,2.333038138,123820,4760,128580,70507,1978,72485,0.972711596,0,53313,2782,56095,0.950405562,0
91732,37,Los Angeles,4.539681244,212775,7671,220446,129587,2730,132317,0.979367731,0,83188,4941,88129,0.94393446,0
91745,37,Los Angeles,12.95033425,177792,7648,185440,112133,2777,114910,0.975833261,0,65659,4871,70530,0.93093719,0
91789,37,Los Angeles,15.86710384,144141,5510,149651,92329,1750,94079,0.981398612,0,51812,3760,55572,0.932340027,0
93535,37,Los Angeles,238.9838179,181580,7061,188641,122622,2719,125341,0.978307178,0,58958,4342,63300,0.931406003,0
93536,37,Los Angeles,254.3567807,153818,5411,159229,115071,2477,117548,0.978927757,0,38747,2934,41681,0.929608215,0
90019,37,Los Angeles,3.87068257,1052373,36310,1088683,644305,11764,656069,0.982068959,0,408068,24546,432614,0.943261198,0
90022,37,Los Angeles,4.422367767,532764,18227,550991,331669,6932,338601,0.979527526,0,201095,11295,212390,0.94681953,0
90023,37,Los Angeles,4.31740074,454748,16043,470791,284970,5740,290710,0.980255237,0,169778,10303,180081,0.942786857,0
90025,37,Los Angeles,2.550898908,1093241,32781,1126022,751194,12412,763606,0.983745544,0,342047,20369,362416,0.943796631,0
90044,37,Los Angeles,5.102188939,813618,34483,848101,453502,10888,464390,0.976554189,0,360116,23595,383711,0.938508409,0
90222,37,Los Angeles,2.706569894,181013,7355,188368,102989,2287,105276,0.97827615,0,78024,5068,83092,0.939007365,0
90280,37,Los Angeles,7.379501834,621051,21119,642170,381877,7028,388905,0.981928749,0,239174,14091,253265,0.944362624,0
90601,37,Los Angeles,10.6019477,174401,7407,181808,109151,2692,111843,0.975930545,0,65250,4715,69965,0.932609162,0
90723,37,Los Angeles,4.747753504,289599,10692,300291,170087,3585,173672,0.97935764,0,119512,7107,126619,0.943870983,0
91105,37,Los Angeles,4.195712318,280103,10880,290983,177275,4391,181666,0.975829269,0,102828,6489,109317,0.940640523,0
91202,37,Los Angeles,4.921456323,143435,4359,147794,96459,1699,98158,0.982691171,0,46976,2660,49636,0.946409864,0
91740,37,Los Angeles,5.009481875,110581,4545,115126,62948,1594,64542,0.975302904,0,47633,2951,50584,0.941661395,0
91746,37,Los Angeles,5.80910342,143525,5265,148790,88147,1892,90039,0.978986883,0,55378,3373,58751,0.942588211,0
90024,37,Los Angeles,2.973889825,1313974,46915,1360889,907814,17256,925070,0.981346276,0,406160,29659,435819,0.931946519,0
90026,37,Los Angeles,4.029754361,1513317,46615,1559932,891402,15493,906895,0.982916435,0,621915,31122,653037,0.95234267,0
90031,37,Los Angeles,3.499616473,386354,14200,400554,233265,4762,238027,0.979993866,0,153089,9438,162527,0.941929649,0
90034,37,Los Angeles,3.101177915,967870,32609,1000479,615333,9953,625286,0.984082484,0,352537,22656,375193,0.939615078,0
90049,37,Los Angeles,14.97241189,684310,28759,713069,471068,9598,480666,0.980031872,0,213242,19161,232403,0.917552699,0
90221,37,Los Angeles,5.381867289,346965,14495,361460,192355,4398,196753,0.977647101,0,154610,10097,164707,0.938697202,0
90290,37,Los Angeles,18.72540491,15516,2265,17781,10396,822,11218,0.926724906,0,5120,1443,6563,0.780131038,0
90404,37,Los Angeles,1.971018846,768202,22175,790377,520033,8098,528131,0.984666683,0,248169,14077,262246,0.946321393,0
90638,37,Los Angeles,7.749781436,163246,6444,169690,100322,2315,102637,0.977444781,0,62924,4129,67053,0.938421845,0
90670,37,Los Angeles,8.320491912,208570,9197,217767,124581,2914,127495,0.977144202,0,83989,6283,90272,0.930399238,0
90732,37,Los Angeles,3.576665086,79423,3737,83160,50468,1192,51660,0.976926055,0,28955,2545,31500,0.919206349,0
91008,37,Los Angeles,1.925465129,2993,157,3150,1343,34,1377,0.975308642,0,1650,123,1773,0.930626058,0
91344,37,Los Angeles,14.46213519,245930,8398,254328,165098,3470,168568,0.979414836,0,80832,4928,85760,0.942537313,0
91355,37,Los Angeles,13.15409373,247648,8824,256472,159675,3650,163325,0.977651921,0,87973,5174,93147,0.944453391,0
91741,37,Los Angeles,20.36933608,67526,2583,70109,42579,1111,43690,0.97457084,0,24947,1472,26419,0.944282524,0
91770,37,Los Angeles,6.524344236,262674,8949,271623,171941,3794,175735,0.978410675,0,90733,5155,95888,0.946239363,0
93551,37,Los Angeles,84.75614245,136381,5126,141507,98540,2086,100626,0.979269771,0,37841,3040,40881,0.925637827,0
93591,37,Los Angeles,74.32429251,1834,157,1991,916,54,970,0.944329897,0,918,103,1021,0.899118511,0
90008,37,Los Angeles,2.89338365,464348,22766,487114,256621,6280,262901,0.976112681,0,207727,16486,224213,0.926471703,0
90035,37,Los Angeles,2.275870796,611800,19611,631411,390038,6675,396713,0.983174234,0,221762,12936,234698,0.944882359,0
90042,37,Los Angeles,4.519293791,579271,20413,599684,329466,5712,335178,0.982958309,0,249805,14701,264506,0.944420921,0
90201,37,Los Angeles,5.987976173,599859,20094,619953,381621,7613,389234,0.980441071,0,218238,12481,230719,0.945903892,0
90230,37,Los Angeles,4.539899393,666991,26194,693185,418904,8512,427416,0.980084976,0,248087,17682,265769,0.933468538,0
90272,37,Los Angeles,23.8112713,192801,12078,204879,135537,3593,139130,0.974175232,0,57264,8485,65749,0.870948608,0
90403,37,Los Angeles,1.411627011,582276,18797,601073,385435,6665,392100,0.983001785,0,196841,12132,208973,0.941944653,0
90755,37,Los Angeles,2.172800698,144771,4986,149757,89912,1877,91789,0.979550927,0,54859,3109,57968,0.946366961,0
91316,37,Los Angeles,5.457468012,225330,7899,233229,142738,3200,145938,0.97807288,0,82592,4699,87291,0.946168563,0
91401,37,Los Angeles,3.5388682,397323,11377,408700,237900,4410,242310,0.981800173,0,159423,6967,166390,0.958128493,0
91766,37,Los Angeles,10.09854289,239295,11746,251041,129524,3592,133116,0.973016016,0,109771,8154,117925,0.930854357,0
90003,37,Los Angeles,3.62531922,618220,25941,644161,353141,8280,361421,0.977090429,0,265079,17661,282740,0.937536252,0
90032,37,Los Angeles,4.814965344,387966,15366,403332,232616,4789,237405,0.979827721,0,155350,10577,165927,0.9362551,0
90043,37,Los Angeles,4.102011036,493378,21911,515289,267816,6301,274117,0.977013465,0,225562,15610,241172,0.93527441,0
90069,37,Los Angeles,2.151830227,2125962,88650,2214612,1414851,42652,1457503,0.970736252,0,711111,45998,757109,0.939245208,0
90240,37,Los Angeles,3.009333407,132113,4741,136854,86856,2175,89031,0.975570307,0,45257,2566,47823,0.946343809,0
90603,37,Los Angeles,3.16341017,74287,3263,77550,45522,1127,46649,0.975840854,0,28765,2136,30901,0.930876023,0
91011,37,Los Angeles,11.26125439,86287,4016,90303,59742,1167,60909,0.98084027,0,26545,2849,29394,0.903075458,0
91208,37,Los Angeles,7.391106964,105812,3879,109691,72567,1404,73971,0.981019589,0,33245,2475,35720,0.930711086,0
91340,37,Los Angeles,3.43101157,181893,6371,188264,114055,2540,116595,0.978215189,0,67838,3831,71669,0.946545926,0
91436,37,Los Angeles,5.220576944,172950,6810,179760,112783,2506,115289,0.978263321,0,60167,4304,64471,0.933241302,0
91706,37,Los Angeles,13.52995562,327417,12631,340048,193790,4424,198214,0.977680689,0,133627,8207,141834,0.942136582,0
91744,37,Los Angeles,8.691921718,280468,9703,290171,167420,3540,170960,0.979293402,0,113048,6163,119211,0.948301751,0
91803,37,Los Angeles,3.259896807,196105,6438,202543,123156,2436,125592,0.98060386,0,72949,4002,76951,0.947992879,0
92397,37,Los Angeles,47.594835,244,98,342,172,72,244,0.704918033,0,72,26,98,0.734693878,0
93543,37,Los Angeles,67.68905725,5757,466,6223,3533,178,3711,0.952034492,0,2224,288,2512,0.885350318,0
93553,37,Los Angeles,57.19630789,661,71,732,255,20,275,0.927272727,0,406,51,457,0.888402626,0
90020,37,Los Angeles,1.111911404,805530,23362,828892,496127,8462,504589,0.983229916,0,309403,14900,324303,0.954055312,0
90004,37,Los Angeles,3.050788244,1151855,32111,1183966,736906,12416,749322,0.983430354,0,414949,19695,434644,0.954687054,0
90006,37,Los Angeles,1.933701115,936091,27995,964086,588367,10346,598713,0.9827196,0,347724,17649,365373,0.951695938,0
90010,37,Los Angeles,0.390477093,560757,19197,579954,347479,7891,355370,0.977794974,0,213278,11306,224584,0.949658034,0
90011,37,Los Angeles,4.288999311,922253,33148,955401,536053,9489,545542,0.982606289,0,386200,23659,409859,0.94227527,0
90013,37,Los Angeles,0.705305972,884349,34827,919176,509273,13598,522871,0.973993585,0,375076,21229,396305,0.946432672,0
90014,37,Los Angeles,0.299382013,785280,32225,817505,471880,14168,486048,0.970850616,0,313400,18057,331457,0.945522345,0
90015,37,Los Angeles,1.693270244,1781997,72288,1854285,1132463,33518,1165981,0.971253391,0,649534,38770,688304,0.943673144,0
90017,37,Los Angeles,0.706996335,1463080,58357,1521437,933336,28271,961607,0.970600256,0,529744,30086,559830,0.946258686,0
90018,37,Los Angeles,3.000774638,567320,20552,587872,347842,6933,354775,0.980458037,0,219478,13619,233097,0.94157368,0
90073,37,Los Angeles,0.536435245,15729,1082,16811,9576,356,9932,0.964156263,0,6153,726,6879,0.894461404,0
90401,37,Los Angeles,0.754524203,1111455,39511,1150966,766966,15261,782227,0.980490318,0,344489,24250,368739,0.934235326,0
90028,37,Los Angeles,1.510590119,2730508,105446,2835954,1737656,46101,1783757,0.974155112,0,992852,59345,1052197,0.943598965,0
90029,37,Los Angeles,1.376126285,777861,22163,800024,482953,8185,491138,0.983334623,0,294908,13978,308886,0.954747059,0
90094,37,Los Angeles,0.714504129,220483,7933,228416,148689,2520,151209,0.983334325,0,71794,5413,77207,0.929889777,0
90502,37,Los Angeles,2.239058861,151191,6189,157380,89583,2137,91720,0.976700829,0,61608,4052,65660,0.938288151,0
90095,37,Los Angeles,0.399649381,249822,11437,261259,154024,3100,157124,0.98027036,0,95798,8337,104135,0.919940462,0
90260,37,Los Angeles,2.470475359,290732,9845,300577,177505,3414,180919,0.981129677,0,113227,6431,119658,0.946255161,0
90263,37,Los Angeles,0.233857448,9394,582,9976,7086,236,7322,0.967768369,0,2308,346,2654,0.869630746,0
90211,37,Los Angeles,0.700163451,315804,9573,325377,206365,3829,210194,0.981783495,0,109439,5744,115183,0.95013153,0
90033,37,Los Angeles,3.276103525,626973,24493,651466,368697,8094,376791,0.978518595,0,258276,16399,274675,0.940296714,0
91210,37,Los Angeles,0.095472728,68876,3134,72010,43722,1547,45269,0.965826504,0,25154,1587,26741,0.94065293,0
90212,37,Los Angeles,0.946665422,536676,17603,554279,366209,6992,373201,0.981264788,0,170467,10611,181078,0.941400943,0
90036,37,Los Angeles,2.455751666,1632735,51232,1683967,1048157,18761,1066918,0.982415706,0,584578,32471,617049,0.947376951,0
90266,37,Los Angeles,4.048341411,580426,20030,600456,407997,7350,415347,0.982303953,0,172429,12680,185109,0.931499819,0
90270,37,Los Angeles,1.189205965,163638,5462,169100,106217,1987,108204,0.981636538,0,57421,3475,60896,0.942935497,0
90037,37,Los Angeles,2.887618344,716444,33535,749979,404704,11011,415715,0.973513104,0,311740,22524,334264,0.932616136,0
90038,37,Los Angeles,1.547900129,1010992,28973,1039965,634158,11044,645202,0.98288288,0,376834,17929,394763,0.954582876,0
91321,37,Los Angeles,26.65938463,122092,5981,128073,75756,1905,77661,0.975470313,0,46336,4076,50412,0.919146235,0
90245,37,Los Angeles,5.347822176,513501,19149,532650,323024,5466,328490,0.983360224,0,190477,13683,204160,0.932979036,0
90247,37,Los Angeles,3.75649808,377332,13726,391058,225841,4910,230751,0.978721652,0,151491,8816,160307,0.945005521,0
90291,37,Los Angeles,2.46360734,1234048,41353,1275401,823816,13689,837505,0.983655023,0,410232,27664,437896,0.936825182,0
90249,37,Los Angeles,2.971696754,258110,8961,267071,154693,3325,158018,0.978958093,0,103417,5636,109053,0.948318707,0
90048,37,Los Angeles,1.893701504,1520718,48453,1569171,1019825,21539,1041364,0.97931655,0,500893,26914,527807,0.949007876,0
91214,37,Los Angeles,7.278203182,91739,4020,95759,62324,1467,63791,0.977003026,0,29415,2553,31968,0.920138889,0
90292,37,Los Angeles,2.096037416,846904,32675,879579,567443,11173,578616,0.98069013,0,279461,21502,300963,0.928556002,0
90701,37,Los Angeles,1.628450706,102342,3556,105898,62316,1246,63562,0.980397093,0,40026,2310,42336,0.945436508,0
90254,37,Los Angeles,1.429436448,393666,17164,410830,260977,6653,267630,0.975141053,0,132689,10511,143200,0.926599162,0
90057,37,Los Angeles,0.879990653,687455,22781,710236,410241,8381,418622,0.979979552,0,277214,14400,291614,0.950619655,0
90301,37,Los Angeles,2.481285887,560629,23321,583950,314123,7482,321605,0.976735436,0,246506,15839,262345,0.939625303,0
90302,37,Los Angeles,1.913224085,358031,13950,371981,206212,4385,210597,0.979178241,0,151819,9565,161384,0.940731423,0
90710,37,Los Angeles,2.334468267,129180,5194,134374,78407,1883,80290,0.976547515,0,50773,3311,54084,0.938780416,0
90713,37,Los Angeles,3.46786173,101838,3365,105203,62436,1181,63617,0.98143578,0,39402,2184,41586,0.947482326,0
90062,37,Los Angeles,1.908260331,339854,13969,353823,185961,3908,189869,0.979417388,0,153893,10061,163954,0.938635227,0
90303,37,Los Angeles,1.940706201,349255,13907,363162,199093,4184,203277,0.979417248,0,150162,9723,159885,0.939187541,0
90716,37,Los Angeles,0.921270585,74272,2923,77195,45691,1128,46819,0.975907217,0,28581,1795,30376,0.940907295,0
91304,37,Los Angeles,9.722726169,289742,9117,298859,175129,3457,178586,0.98064238,0,114613,5660,120273,0.952940394,0
90305,37,Los Angeles,2.613762443,187488,15582,203070,101062,6079,107141,0.943261683,0,86426,9503,95929,0.900937151,0
90660,37,Los Angeles,7.750540516,319774,12504,332278,199378,4603,203981,0.977434173,0,120396,7901,128297,0.938416331,0
90810,37,Los Angeles,6.539645541,210069,9772,219841,123694,2909,126603,0.977022661,0,86375,6863,93238,0.926392673,0
91203,37,Los Angeles,0.877885614,256301,7713,264014,167183,3299,170482,0.980648983,0,89118,4414,93532,0.952807595,0
90250,37,Los Angeles,6.768097532,1015610,35135,1050745,593532,11269,604801,0.981367425,0,422078,23866,445944,0.946482069,0
90255,37,Los Angeles,3.726380031,598456,18504,616960,379126,6992,386118,0.981891546,0,219330,11512,230842,0.950130392,0
90704,37,Los Angeles,76.08897077,0,0,0,0,0,0,0,0,0,0,0,0,0
90712,37,Los Angeles,4.216174676,217679,7812,225491,127124,2978,130102,0.977110267,0,90555,4834,95389,0.949323297,0
90813,37,Los Angeles,3.07951902,478820,17155,495975,265910,5578,271488,0.979453972,0,212910,11577,224487,0.948429085,0
90814,37,Los Angeles,1.332751353,173399,5380,178779,95532,1764,97296,0.981869758,0,77867,3616,81483,0.955622645,0
90021,37,Los Angeles,1.977013498,560719,19465,580184,351412,7774,359186,0.978356617,0,209307,11691,220998,0.947099069,0
90265,37,Los Angeles,111.010356,130856,10924,141780,93666,4465,98131,0.954499597,0,37190,6459,43649,0.852024101,0
90706,37,Los Angeles,6.105282314,421525,14607,436132,255900,5471,261371,0.979068068,0,165625,9136,174761,0.94772289,0
90822,37,Los Angeles,0.16248109,7407,451,7858,4410,136,4546,0.97008359,0,2997,315,3312,0.904891304,0
90831,37,Los Angeles,0.022553884,17675,459,18134,11656,150,11806,0.987294596,0,6019,309,6328,0.951169406,0
90275,37,Los Angeles,13.53227302,107154,6139,113293,71182,1891,73073,0.974121769,0,35972,4248,40220,0.894380905,0
90274,37,Los Angeles,11.97330406,81185,4317,85502,57444,1481,58925,0.974866356,0,23741,2836,26577,0.893291192,0
90715,37,Los Angeles,1.694651725,80822,2888,83710,48999,1030,50029,0.979411941,0,31823,1858,33681,0.944835367,0
90717,37,Los Angeles,2.003056218,107039,4071,111110,64363,1402,65765,0.97868167,0,42676,2669,45345,0.941140148,0
91006,37,Los Angeles,6.429692752,161177,5479,166656,91759,2026,93785,0.978397398,0,69418,3453,72871,0.952614895,0
90277,37,Los Angeles,3.579211829,370029,13819,383848,241288,4896,246184,0.980112436,0,128741,8923,137664,0.935182764,0
90041,37,Los Angeles,3.593955213,282343,10197,292540,169078,3024,172102,0.982429025,0,113265,7173,120438,0.940442385,0
90731,37,Los Angeles,9.252530167,328408,17501,345909,198652,5569,204221,0.972730522,0,129756,11932,141688,0.915786799,0
91042,37,Los Angeles,49.79855569,86035,4063,90098,57755,1460,59215,0.975344085,0,28280,2603,30883,0.915714147,0
90293,37,Los Angeles,2.740663271,179707,8413,188120,112631,2313,114944,0.979877158,0,67076,6100,73176,0.916639335,0
90744,37,Los Angeles,8.886253692,264990,11679,276669,160631,3717,164348,0.977383357,0,104359,7962,112321,0.929113879,0
90745,37,Los Angeles,8.227121521,324440,11803,336243,200460,3793,204253,0.981429893,0,123980,8010,131990,0.939313584,0
90503,37,Los Angeles,5.266839162,397424,13561,410985,250453,4799,255252,0.981198972,0,146971,8762,155733,0.943737037,0
90304,37,Los Angeles,1.639582086,289233,11239,300472,169355,3855,173210,0.977743779,0,119878,7384,127262,0.941977967,0
90746,37,Los Angeles,5.785257246,269906,12165,282071,163986,4000,167986,0.976188492,0,105920,8165,114085,0.928430556,0
90747,37,Los Angeles,0.021422599,244,21,265,129,12,141,0.914893617,0,115,9,124,0.927419355,0
91016,37,Los Angeles,8.477952491,387861,13185,401046,91652,2291,93943,0.975612872,0,296209,10894,307103,0.964526559,0
91020,37,Los Angeles,0.718490654,41074,1802,42876,27823,671,28494,0.976451183,0,13251,1131,14382,0.921360033,0
91024,37,Los Angeles,3.494639206,35272,1512,36784,21686,434,22120,0.980379747,0,13586,1078,14664,0.926486634,0
90046,37,Los Angeles,5.665720968,2133769,75739,2209508,1338510,27050,1365560,0.980191277,0,795259,48689,843948,0.942308057,0
90402,37,Los Angeles,2.042226477,172407,6115,178522,122661,2223,124884,0.982199481,0,49746,3892,53638,0.927439502,0
90405,37,Los Angeles,2.78191965,806372,24837,831209,544938,8987,553925,0.983775782,0,261434,15850,277284,0.94283839,0
91046,37,Los Angeles,0.005073794,463,26,489,310,13,323,0.959752322,0,153,13,166,0.921686747,0
90059,37,Los Angeles,3.161695482,333710,17535,351245,183985,5222,189207,0.972400598,0,149725,12313,162038,0.924011652,0
90061,37,Los Angeles,2.713477682,221439,9862,231301,126500,3108,129608,0.976019999,0,94939,6754,101693,0.933584416,0
90504,37,Los Angeles,4.410267652,177399,5747,183146,112776,2062,114838,0.982044271,0,64623,3685,68308,0.946053171,0
90803,37,Los Angeles,4.064533844,402914,16526,419440,238339,6086,244425,0.975100747,0,164575,10440,175015,0.94034797,0
91101,37,Los Angeles,1.270267744,401981,11724,413705,245870,4379,250249,0.982501429,0,156111,7345,163456,0.95506436,0
91103,37,Los Angeles,4.589323418,295107,13538,308645,175465,4762,180227,0.973577766,0,119642,8776,128418,0.931660671,0
90065,37,Los Angeles,5.490257515,451302,17346,468648,265729,4994,270723,0.9815531,0,185573,12352,197925,0.937592522,0
90067,37,Los Angeles,0.430162028,397442,16569,414011,269990,6695,276685,0.975802808,0,127452,9874,137326,0.928098102,0
90505,37,Los Angeles,5.851767535,261012,9219,270231,163566,3069,166635,0.981582501,0,97446,6150,103596,0.940634774,0
90506,37,Los Angeles,0.155935468,36907,867,37774,24120,371,24491,0.984851578,0,12787,496,13283,0.962659038,0
91104,37,Los Angeles,3.770791267,194593,6022,200615,111499,1935,113434,0.982941622,0,83094,4087,87181,0.953120519,0
90071,37,Los Angeles,0.134793953,297330,13169,310499,195617,6182,201799,0.969365557,0,101713,6987,108700,0.935722171,0
90079,37,Los Angeles,0.009878473,11443,429,11872,7875,236,8111,0.970903711,0,3568,193,3761,0.948683861,0
90604,37,Los Angeles,4.208897,139823,5246,145069,85598,1964,87562,0.977570179,0,54225,3282,57507,0.942928687,0
90804,37,Los Angeles,2.158971222,361116,11766,372882,201913,3933,205846,0.980893483,0,159203,7833,167036,0.953105917,0
90089,37,Los Angeles,0.326032847,321052,12923,333975,95419,2369,97788,0.975774124,0,225633,10554,236187,0.955315068,0
90606,37,Los Angeles,3.793569477,160289,6817,167106,97898,2628,100526,0.97385751,0,62391,4189,66580,0.937083208,0
91106,37,Los Angeles,2.716793544,326184,8816,335000,204945,3417,208362,0.983600657,0,121239,5399,126638,0.957366667,0
90805,37,Los Angeles,7.41884275,519033,20915,539948,293113,6810,299923,0.977294172,0,225920,14105,240025,0.941235288,0
91107,37,Los Angeles,8.458219098,301746,9605,311351,183527,3341,186868,0.982121069,0,118219,6264,124483,0.949679876,0
91108,37,Los Angeles,3.789011904,57072,1523,58595,41148,645,41793,0.984566793,0,15924,878,16802,0.947744316,0
90808,37,Los Angeles,6.866672606,205302,7052,212354,126658,2411,129069,0.981320069,0,78644,4641,83285,0.94427568,0
91201,37,Los Angeles,2.383171822,185925,5627,191552,120706,2106,122812,0.982851839,0,65219,3521,68740,0.948778004,0
90241,37,Los Angeles,4.876049711,365334,13732,379066,226784,5738,232522,0.975322765,0,138550,7994,146544,0.945449831,0
90640,37,Los Angeles,8.322572241,465248,16106,481354,292852,6490,299342,0.978319113,0,172396,9616,182012,0.947168319,0
90703,37,Los Angeles,8.748431139,321090,11261,332351,202084,4358,206442,0.978889955,0,119006,6903,125909,0.94517469,0
91010,37,Los Angeles,6.431204349,131282,5436,136718,56954,1441,58395,0.97532323,0,74328,3995,78323,0.948993271,0
91356,37,Los Angeles,7.33336201,261410,9917,271327,166309,4132,170441,0.975757007,0,95101,5785,100886,0.94265805,0
91722,37,Los Angeles,4.124687315,149102,4957,154059,85347,1804,87151,0.979300295,0,63755,3153,66908,0.95287559,0
91364,37,Los Angeles,7.539454328,266000,10746,276746,169027,4358,173385,0.974865184,0,96973,6388,103361,0.938197192,0
91303,37,Los Angeles,2.115468876,283045,10234,293279,168478,4744,173222,0.972613178,0,114567,5490,120057,0.954271721,0
91411,37,Los Angeles,1.951674259,321716,10489,332205,184514,3769,188283,0.979982261,0,137202,6720,143922,0.953308042,0
91367,37,Los Angeles,7.487473136,392981,14149,407130,245972,5841,251813,0.976804216,0,147009,8308,155317,0.946509397,0
91306,37,Los Angeles,4.157533575,250042,7066,257108,149836,2775,152611,0.981816514,0,100206,4291,104497,0.95893662,0
91371,37,Los Angeles,0.209202386,25940,543,26483,17102,213,17315,0.987698527,0,8838,330,9168,0.964005236,0
91381,37,Los Angeles,39.52794899,84061,3448,87509,55851,1181,57032,0.979292327,0,28210,2267,30477,0.925616038,0
91342,37,Los Angeles,45.44491252,359445,16962,376407,218359,6049,224408,0.973044633,0,141086,10913,151999,0.928203475,0
91326,37,Los Angeles,8.099571653,114334,4573,118907,76032,1690,77722,0.978255835,0,38302,2883,41185,0.929998786,0
91330,37,Los Angeles,0.499222534,45922,1328,47250,29758,584,30342,0.980752752,0,16164,744,16908,0.955997161,0
91724,37,Los Angeles,6.235619468,82079,3176,85255,48676,1175,49851,0.976429761,0,33403,2001,35404,0.943480963,0
91387,37,Los Angeles,53.42102739,98130,5437,103567,60475,1826,62301,0.970690679,0,37655,3611,41266,0.912494548,0
91324,37,Los Angeles,4.257673142,370254,10622,380876,227267,4364,231631,0.981159689,0,142987,6258,149245,0.958068947,0
91325,37,Los Angeles,4.81578427,304230,8671,312901,197531,3643,201174,0.981891298,0,106699,5028,111727,0.954997449,0
91501,37,Los Angeles,2.728109869,110140,3089,113229,68402,997,69399,0.985633799,0,41738,2092,43830,0.952270135,0
91502,37,Los Angeles,1.343231376,345313,10673,355986,216527,4240,220767,0.980794231,0,128786,6433,135219,0.952425325,0
91390,37,Los Angeles,158.1252714,22149,1118,23267,14921,461,15382,0.970029905,0,7228,657,7885,0.916677235,0
91733,37,Los Angeles,6.74672783,190021,7134,197155,121476,2813,124289,0.977367265,0,68545,4321,72866,0.940699366,0
91504,37,Los Angeles,9.319670964,303807,9249,313056,192704,3108,195812,0.984127633,0,111103,6141,117244,0.947622053,0
91335,37,Los Angeles,6.566350043,489620,14439,504059,295752,5705,301457,0.981075245,0,193868,8734,202602,0.95689085,0
91506,37,Los Angeles,2.423276066,216521,6157,222678,132807,2126,134933,0.984244032,0,83714,4031,87745,0.95406006,0
91601,37,Los Angeles,2.636607836,865517,25900,891417,520851,10711,531562,0.979849952,0,344666,15189,359855,0.957791333,0
91402,37,Los Angeles,3.726114392,479144,14996,494140,289146,5726,294872,0.980581405,0,189998,9270,199268,0.953479736,0
91403,37,Los Angeles,3.587157851,355833,13381,369214,223644,5008,228652,0.978097721,0,132189,8373,140562,0.94043198,0
91343,37,Los Angeles,5.923183276,387911,12056,399967,237421,4723,242144,0.980495077,0,150490,7333,157823,0.953536557,0
91602,37,Los Angeles,2.040239971,338368,9622,347990,212348,3866,216214,0.982119567,0,126020,5756,131776,0.956319815,0
91405,37,Los Angeles,3.398356818,459511,14287,473798,270165,5615,275780,0.979639568,0,189346,8672,198018,0.956206001,0
91406,37,Los Angeles,8.058730336,506790,15420,522210,307177,5692,312869,0.981807082,0,199613,9728,209341,0.953530364,0
91351,37,Los Angeles,8.686115485,109966,4494,114460,64901,1474,66375,0.977792844,0,45065,3020,48085,0.937194551,0
91204,37,Los Angeles,1.044211915,348926,11236,360162,212928,4248,217176,0.980439828,0,135998,6988,142986,0.951128082,0
91205,37,Los Angeles,1.895250168,376151,10720,386871,231614,3916,235530,0.983373668,0,144537,6804,151341,0.955041925,0
91307,37,Los Angeles,8.140143083,130627,5361,135988,80918,1983,82901,0.976079903,0,49709,3378,53087,0.936368602,0
91345,37,Los Angeles,3.244100131,129474,5157,134631,81109,2304,83413,0.972378406,0,48365,2853,51218,0.944296927,0
91605,37,Los Angeles,5.370030882,475978,14168,490146,290244,5436,295680,0.98161526,0,185734,8732,194466,0.955097549,0
91748,37,Los Angeles,14.17588496,242630,9439,252069,157753,3765,161518,0.976689905,0,84877,5674,90551,0.937339179,0
91350,37,Los Angeles,15.86570305,116164,4311,120475,74664,1556,76220,0.979585411,0,41500,2755,44255,0.937747147,0
91606,37,Los Angeles,3.329061947,462058,12878,474936,278318,5024,283342,0.982268778,0,183740,7854,191594,0.959007067,0
91759,37,Los Angeles,82.53133005,146,37,183,96,17,113,0.849557522,0,50,20,70,0.714285714,0
91207,37,Los Angeles,1.590754206,54962,1750,56712,36474,612,37086,0.983497816,0,18488,1138,19626,0.942015693,0
91607,37,Los Angeles,2.467890006,345469,9995,355464,210546,3781,214327,0.982358732,0,134923,6214,141137,0.955971857,0
91608,37,Los Angeles,0.590922252,276413,13606,290019,186584,6031,192615,0.968688835,0,89829,7575,97404,0.92223112,0
91750,37,Los Angeles,18.53748844,102256,4009,106265,64787,1384,66171,0.979084493,0,37469,2625,40094,0.934528857,0
91755,37,Los Angeles,3.15049383,128925,4291,133216,87821,1987,89808,0.977875022,0,41104,2304,43408,0.946922226,0
91780,37,Los Angeles,3.845396613,120820,3664,124484,81983,1742,83725,0.979193789,0,38837,1922,40759,0.95284477,0
91767,37,Los Angeles,5.684772502,201515,8845,210360,107445,2670,110115,0.975752622,0,94070,6175,100245,0.938400918,0
91768,37,Los Angeles,8.200076089,172040,8633,180673,95004,2069,97073,0.978686143,0,77036,6564,83600,0.921483254,0
91773,37,Los Angeles,14.97615709,108488,4840,113328,64741,1576,66317,0.976235354,0,43747,3264,47011,0.930569441,0
91775,37,Los Angeles,3.099386006,83956,2453,86409,55087,1036,56123,0.981540545,0,28869,1417,30286,0.953212706,0
91776,37,Los Angeles,3.340860129,246740,7440,254180,172228,3685,175913,0.979052145,0,74512,3755,78267,0.952023203,0
91790,37,Los Angeles,5.755545379,241276,8099,249375,142628,3207,145835,0.978009394,0,98648,4892,103540,0.952752559,0
91792,37,Los Angeles,3.841616268,113196,4249,117445,68035,1435,69470,0.979343602,0,45161,2814,47975,0.94134445,0
91801,37,Los Angeles,4.324050997,386271,11361,397632,244799,4891,249690,0.980411711,0,141472,6470,147942,0.956266645,0
93510,37,Los Angeles,80.07782899,4763,458,5221,3228,150,3378,0.955595027,0,1535,308,1843,0.832881172,0
93534,37,Los Angeles,18.9567967,233533,8775,242308,153272,3455,156727,0.977955298,0,80261,5320,85581,0.937836669,0
93544,37,Los Angeles,114.9664182,131,20,151,61,13,74,0.824324324,0,70,7,77,0.909090909,0
93550,37,Los Angeles,259.2553576,196176,7580,203756,134467,2854,137321,0.97921658,0,61709,4726,66435,0.928862798,0
93552,37,Los Angeles,38.44010963,69868,2649,72517,51288,1087,52375,0.979245823,0,18580,1562,20142,0.922450601,0
93563,37,Los Angeles,37.81391214,11,7,18,5,1,6,0.833333333,0,6,6,12,0.5,0
90840,37,Los Angeles,0.042357548,0,0,0,0,0,0,0,0,0,0,0,0,0
90052,37,Los Angeles,0.139646123,0,0,0,0,0,0,0,0,0,0,0,0,0
90639,37,Los Angeles,0.140477405,0,0,0,0,0,0,0,0,0,0,0,0,0
91125,37,Los Angeles,0.177195131,0,0,0,0,0,0,0,0,0,0,0,0,0
96014,93,Siskiyou,154.7267995,0,0,0,0,0,0,0,0,0,0,0,0,0
96031,93,Siskiyou,314.9314796,0,0,0,0,0,0,0,0,0,0,0,0,0
96023,93,Siskiyou,214.5549395,0,0,0,0,0,0,0,0,0,0,0,0,0
96032,93,Siskiyou,519.6487401,0,0,0,0,0,0,0,0,0,0,0,0,0
96058,93,Siskiyou,364.6895376,0,0,0,0,0,0,0,0,0,0,0,0,0
95568,93,Siskiyou,97.00325183,0,0,0,0,0,0,0,0,0,0,0,0,0
96064,93,Siskiyou,487.0057998,0,0,0,0,0,0,0,0,0,0,0,0,0
96067,93,Siskiyou,76.37696966,20,5,25,13,5,18,0.722222222,0,7,0,7,1,1
96085,93,Siskiyou,55.30218862,0,0,0,0,0,0,0,0,0,0,0,0,0
96094,93,Siskiyou,200.3885643,7,0,7,6,0,6,1,1,1,0,1,1,1
96097,93,Siskiyou,181.7269079,6,0,6,6,0,6,1,1,0,0,0,0,0
96039,93,Siskiyou,264.1614505,0,0,0,0,0,0,0,0,0,0,0,0,0
96044,93,Siskiyou,220.6139345,0,0,0,0,0,0,0,0,0,0,0,0,0
96086,93,Siskiyou,203.1375647,0,0,0,0,0,0,0,0,0,0,0,0,0
96038,93,Siskiyou,18.2714859,1,0,1,1,0,1,1,1,0,0,0,0,0
96037,93,Siskiyou,2.742161741,0,0,0,0,0,0,0,0,0,0,0,0,0
96025,93,Siskiyou,103.4967212,9,0,9,8,0,8,1,1,1,0,1,1,1
96027,93,Siskiyou,419.1902768,1,0,1,1,0,1,1,1,0,0,0,0,0
96034,93,Siskiyou,112.0050458,0,0,0,0,0,0,0,0,0,0,0,0,0
96050,93,Siskiyou,258.6641705,0,0,0,0,0,0,0,0,0,0,0,0,0
96057,93,Siskiyou,106.5392032,0,0,0,0,0,0,0,0,0,0,0,0,0
96059,103,Tehama,63.5337125,0,0,0,0,0,0,0,0,0,0,0,0,0
96074,103,Tehama,90.69149148,0,0,0,0,0,0,0,0,0,0,0,0,0
96075,103,Tehama,90.68956173,0,0,0,0,0,0,0,0,0,0,0,0,0
96080,103,Tehama,647.5481842,367,24,391,205,24,229,0.895196507,0,162,0,162,1,1
96090,103,Tehama,3.056268219,4,0,4,4,0,4,1,1,0,0,0,0,0
96092,103,Tehama,66.51698427,5,1,6,4,1,5,0.8,0,1,0,1,1,1
96061,103,Tehama,34.06670565,0,0,0,0,0,0,0,0,0,0,0,0,0
96063,103,Tehama,12.96357916,1,0,1,0,0,0,0,0,1,0,1,1,1
96021,103,Tehama,249.6005464,204,17,221,69,17,86,0.802325581,0,135,0,135,1,1
96022,103,Tehama,248.5769397,942,74,1016,635,74,709,0.895627645,0,307,0,307,1,1
96029,103,Tehama,24.37911418,0,0,0,0,0,0,0,0,0,0,0,0,0
96035,103,Tehama,42.53724379,5,0,5,2,0,2,1,1,3,0,3,1,1
96055,103,Tehama,95.2168027,14,4,18,13,4,17,0.764705882,0,1,0,1,1,1
96078,103,Tehama,0.120869882,0,0,0,0,0,0,0,0,0,0,0,0,0
96114,35,Lassen,65.54706457,0,0,0,0,0,0,0,0,0,0,0,0,0
96130,35,Lassen,499.8967755,0,1,1,0,1,1,0,0,0,0,0,0,0
96123,35,Lassen,336.230667,0,0,0,0,0,0,0,0,0,0,0,0,0
96136,35,Lassen,144.8114742,0,0,0,0,0,0,0,0,0,0,0,0,0
96068,35,Lassen,28.62362774,0,0,0,0,0,0,0,0,0,0,0,0,0
96113,35,Lassen,21.85331513,0,0,0,0,0,0,0,0,0,0,0,0,0
96119,35,Lassen,133.2430871,0,0,0,0,0,0,0,0,0,0,0,0,0
96109,35,Lassen,214.0511374,0,0,0,0,0,0,0,0,0,0,0,0,0
96117,35,Lassen,324.333776,0,0,0,0,0,0,0,0,0,0,0,0,0
96121,35,Lassen,33.20252866,0,0,0,0,0,0,0,0,0,0,0,0,0
96128,35,Lassen,22.63228204,0,0,0,0,0,0,0,0,0,0,0,0,0
96132,35,Lassen,122.1193518,0,0,0,0,0,0,0,0,0,0,0,0,0
96006,35,Lassen,201.8198204,0,0,0,0,0,0,0,0,0,0,0,0,0
96056,35,Lassen,216.0807692,0,0,0,0,0,0,0,0,0,0,0,0,0
96009,35,Lassen,202.9427119,0,0,0,0,0,0,0,0,0,0,0,0,0
93246,31,Kings,21.18449715,0,0,0,0,0,0,0,0,0,0,0,0,0
93239,31,Kings,58.17845087,6,0,6,3,0,3,1,1,3,0,3,1,1
93266,31,Kings,59.31228063,34,5,39,9,5,14,0.642857143,0,25,0,25,1,1
93212,31,Kings,118.5330832,19,3,22,10,3,13,0.769230769,0,9,0,9,1,1
93202,31,Kings,1.536536313,629,11,640,275,11,286,0.961538462,0,354,0,354,1,1
93204,31,Kings,70.61650957,6,0,6,2,0,2,1,1,4,0,4,1,1
93230,31,Kings,258.0641636,22836,729,23565,11535,729,12264,0.94055773,0,11301,0,11301,1,1
93245,31,Kings,118.9018122,9112,388,9500,5018,388,5406,0.928227895,0,4094,0,4094,1,1
91708,71,San Bernardino,8.088140656,14753,1063,15816,6541,231,6772,0.965888955,0,8212,832,9044,0.908005307,0
91739,71,San Bernardino,28.42132079,106071,5093,111164,53211,1894,55105,0.965629253,0,52860,3199,56059,0.942935122,0
92322,71,San Bernardino,3.288699399,63,19,82,13,9,22,0.590909091,0,50,10,60,0.833333333,0
92315,71,San Bernardino,29.37395654,23664,1533,25197,17200,988,18188,0.945678469,0,6464,545,7009,0.922242831,0
92337,71,San Bernardino,13.69872712,96069,5947,102016,44302,1596,45898,0.965227243,0,51767,4351,56118,0.922466945,0
92372,71,San Bernardino,25.72193629,452,97,549,316,55,371,0.851752022,0,136,42,178,0.764044944,0
91730,71,San Bernardino,13.72937027,268152,10707,278859,130690,4198,134888,0.968877884,0,137462,6509,143971,0.954789506,0
92256,71,San Bernardino,63.35051615,950,206,1156,309,36,345,0.895652174,0,641,170,811,0.790382244,0
92321,71,San Bernardino,7.12452565,97,27,124,66,23,89,0.741573034,0,31,4,35,0.885714286,0
92368,71,San Bernardino,49.6688529,449,48,497,187,18,205,0.912195122,0,262,30,292,0.897260274,0
91709,71,San Bernardino,44.81430263,129110,7673,136783,69917,2182,72099,0.969736057,0,59193,5491,64684,0.915110383,0
92301,71,San Bernardino,224.7861941,30129,2484,32613,15618,1225,16843,0.927269489,0,14511,1259,15770,0.92016487,0
92356,71,San Bernardino,365.5767306,412,96,508,352,87,439,0.801822323,0,60,9,69,0.869565217,0
92399,71,San Bernardino,53.63559083,37822,3819,41641,17824,1406,19230,0.926885075,0,19998,2413,22411,0.89232966,0
91701,71,San Bernardino,7.391719711,62302,2991,65293,30802,1029,31831,0.967673023,0,31500,1962,33462,0.941366326,0
92336,71,San Bernardino,19.88497971,160978,8749,169727,72454,2554,75008,0.965950299,0,88524,6195,94719,0.934596016,0
92342,71,San Bernardino,98.2408625,202,27,229,177,16,193,0.917098446,0,25,11,36,0.694444444,0
92411,71,San Bernardino,4.705437269,52521,3795,56316,21593,1174,22767,0.948434137,0,30928,2621,33549,0.921875466,0
92335,71,San Bernardino,17.45742484,232098,11893,243991,105903,4084,109987,0.962868339,0,126195,7809,134004,0.94172562,0
92358,71,San Bernardino,72.3648313,309,81,390,239,52,291,0.821305842,0,70,29,99,0.707070707,0
92374,71,San Bernardino,17.94821794,133334,7288,140622,60780,2212,62992,0.96488443,0,72554,5076,77630,0.934612907,0
92304,71,San Bernardino,47.67340409,0,0,0,0,0,0,0,0,0,0,0,0,0
92365,71,San Bernardino,483.3262978,20,4,24,16,4,20,0.8,0,4,0,4,1,1
92404,71,San Bernardino,31.58879547,162865,12066,174931,65218,4068,69286,0.94128684,0,97647,7998,105645,0.924293625,0
92252,71,San Bernardino,112.3206438,4924,344,5268,2230,182,2412,0.924543947,0,2694,162,2856,0.943277311,0
92341,71,San Bernardino,9.996903694,2,1,3,1,1,2,0.5,0,1,0,1,1,1
92385,71,San Bernardino,9.208257929,15,3,18,12,2,14,0.857142857,0,3,1,4,0.75,0
91761,71,San Bernardino,28.49222841,395075,16703,411778,124845,4067,128912,0.968451347,0,270230,12636,282866,0.955328672,0
91710,71,San Bernardino,22.03189792,218052,10254,228306,109648,3143,112791,0.972134301,0,108404,7111,115515,0.938440895,0
91737,71,San Bernardino,10.08712039,49963,2496,52459,25386,947,26333,0.964037519,0,24577,1549,26126,0.940710403,0
91762,71,San Bernardino,14.28962466,162102,7570,169672,75378,2626,78004,0.96633506,0,86724,4944,91668,0.946066239,0
91764,71,San Bernardino,7.90663892,272407,12422,284829,125048,4154,129202,0.967848795,0,147359,8268,155627,0.946872972,0
91763,71,San Bernardino,5.30018311,142681,5823,148504,68213,1908,70121,0.972789892,0,74468,3915,78383,0.950052945,0
91784,71,San Bernardino,9.140249943,41023,1820,42843,21731,550,22281,0.975315291,0,19292,1270,20562,0.93823558,0
91786,71,San Bernardino,8.943336091,218461,9462,227923,102968,3313,106281,0.968827918,0,115493,6149,121642,0.949450025,0
92401,71,San Bernardino,0.680123491,34363,2218,36581,14095,655,14750,0.95559322,0,20268,1563,21831,0.928404562,0
92377,71,San Bernardino,7.193886931,30832,2137,32969,12754,576,13330,0.956789197,0,18078,1561,19639,0.920515301,0
92305,71,San Bernardino,115.9145713,6,3,9,6,0,6,1,1,0,3,3,0,0
92308,71,San Bernardino,103.2370914,32420,2106,34526,17370,1092,18462,0.940851479,0,15050,1014,16064,0.93687749,0
92285,71,San Bernardino,272.1695607,151,8,159,68,8,76,0.894736842,0,83,0,83,1,1
92307,71,San Bernardino,187.4532093,36370,2681,39051,21287,1588,22875,0.930579235,0,15083,1093,16176,0.932430762,0
93562,71,San Bernardino,89.50077198,1,0,1,1,0,1,1,1,0,0,0,0,0
92311,71,San Bernardino,424.4242508,16924,1151,18075,7674,771,8445,0.908703375,0,9250,380,9630,0.960539979,0
92325,71,San Bernardino,8.739068887,877,327,1204,450,187,637,0.706436421,0,427,140,567,0.75308642,0
92309,71,San Bernardino,358.4959119,21,1,22,13,1,14,0.928571429,0,8,0,8,1,1
92310,71,San Bernardino,82.71138467,2,1,3,0,1,1,0,0,2,0,2,1,1
92313,71,San Bernardino,3.614682438,19953,1446,21399,9177,436,9613,0.954644752,0,10776,1010,11786,0.914305108,0
92314,71,San Bernardino,36.60780176,4367,312,4679,2925,165,3090,0.946601942,0,1442,147,1589,0.907488987,0
93558,71,San Bernardino,40.42490583,0,0,0,0,0,0,0,0,0,0,0,0,0
92316,71,San Bernardino,11.51459388,65441,4238,69679,30145,1305,31450,0.958505564,0,35296,2933,38229,0.92327814,0
92324,71,San Bernardino,27.77351382,159734,11469,171203,74173,4121,78294,0.94736506,0,85561,7348,92909,0.92091186,0
92327,71,San Bernardino,24.50995791,119,19,138,85,15,100,0.85,0,34,4,38,0.894736842,0
92332,71,San Bernardino,941.0043681,0,0,0,0,0,0,0,0,0,0,0,0,0
92333,71,San Bernardino,10.08407403,178,14,192,122,11,133,0.917293233,0,56,3,59,0.949152542,0
92338,71,San Bernardino,93.65203793,0,0,0,0,0,0,0,0,0,0,0,0,0
92339,71,San Bernardino,78.94020962,32,15,47,22,6,28,0.785714286,0,10,9,19,0.526315789,0
92346,71,San Bernardino,27.11479362,89093,6333,95426,34390,1634,36024,0.95464135,0,54703,4699,59402,0.920894919,0
92364,71,San Bernardino,524.8346545,17,0,17,11,0,11,1,1,6,0,6,1,1
92373,71,San Bernardino,39.84104967,96606,5346,101952,49099,2038,51137,0.960146274,0,47507,3308,50815,0.934901112,0
92347,71,San Bernardino,171.6442458,28,5,33,20,4,24,0.833333333,0,8,1,9,0.888888889,0
92344,71,San Bernardino,37.58284584,20969,1388,22357,11961,687,12648,0.945683112,0,9008,701,9709,0.927798949,0
92345,71,San Bernardino,98.87633923,86022,5059,91081,51378,3046,54424,0.944032045,0,34644,2013,36657,0.945085523,0
92242,71,San Bernardino,45.21971577,0,0,0,0,0,0,0,0,0,0,0,0,0
92352,71,San Bernardino,11.53455855,692,156,848,406,99,505,0.803960396,0,286,57,343,0.833819242,0
92354,71,San Bernardino,4.979565759,62238,3975,66213,31575,1775,33350,0.946776612,0,30663,2200,32863,0.933055412,0
92359,71,San Bernardino,19.19665112,9162,787,9949,4864,346,5210,0.933589251,0,4298,441,4739,0.906942393,0
92363,71,San Bernardino,372.0240745,5,0,5,1,0,1,1,1,4,0,4,1,1
92371,71,San Bernardino,132.0909699,3359,646,4005,2046,321,2367,0.864385298,0,1313,325,1638,0.801587302,0
92376,71,San Bernardino,13.32431312,195321,11330,206651,79402,3388,82790,0.959077183,0,115919,7942,123861,0.935879736,0
92382,71,San Bernardino,20.41910219,255,74,329,127,30,157,0.808917197,0,128,44,172,0.744186047,0
92391,71,San Bernardino,1.978627799,190,50,240,89,25,114,0.780701754,0,101,25,126,0.801587302,0
92407,71,San Bernardino,81.66414377,116923,9948,126871,49343,2831,52174,0.945739257,0,67580,7117,74697,0.904721743,0
92378,71,San Bernardino,0.802005352,24,5,29,13,4,17,0.764705882,0,11,1,12,0.916666667,0
92386,71,San Bernardino,2.296921576,704,46,750,426,28,454,0.938325991,0,278,18,296,0.939189189,0
92392,71,San Bernardino,37.29087857,85260,4178,89438,44691,1984,46675,0.957493305,0,40569,2194,42763,0.948693964,0
92394,71,San Bernardino,32.03894881,48835,2731,51566,27146,1396,28542,0.951089622,0,21689,1335,23024,0.942017026,0
92395,71,San Bernardino,16.89129124,106230,5809,112039,57939,3295,61234,0.946190025,0,48291,2514,50805,0.950516681,0
92398,71,San Bernardino,100.1892259,283,34,317,179,27,206,0.868932039,0,104,7,111,0.936936937,0
92405,71,San Bernardino,5.010447522,66843,4572,71415,26298,1372,27670,0.950415613,0,40545,3200,43745,0.926848783,0
92408,71,San Bernardino,10.4812562,152539,11018,163557,69557,3556,73113,0.951362959,0,82982,7462,90444,0.917495909,0
92410,71,San Bernardino,8.235072562,138460,8909,147369,55691,3054,58745,0.948012597,0,82769,5855,88624,0.933934374,0
92267,71,San Bernardino,42.40120697,0,0,0,0,0,0,0,0,0,0,0,0,0
92268,71,San Bernardino,69.68344234,830,102,932,482,55,537,0.897579143,0,348,47,395,0.881012658,0
92277,71,San Bernardino,1599.102392,6058,531,6589,2692,271,2963,0.908538643,0,3366,260,3626,0.928295643,0
92278,71,San Bernardino,0.392493714,1278,77,1355,534,77,611,0.873977087,0,744,0,744,1,1
92280,71,San Bernardino,171.0101818,0,0,0,0,0,0,0,0,0,0,0,0,0
92284,71,San Bernardino,127.4780529,12444,790,13234,5489,357,5846,0.938932603,0,6955,433,7388,0.941391446,0
92317,71,San Bernardino,1.60616555,0,0,0,0,0,0,0,0,0,0,0,0,0
92415,71,San Bernardino,0.066289823,0,0,0,0,0,0,0,0,0,0,0,0,0
92369,71,San Bernardino,0.37189622,0,0,0,0,0,0,0,0,0,0,0,0,0
92350,71,San Bernardino,0.066744654,0,0,0,0,0,0,0,0,0,0,0,0,0
91913,73,San Diego,9.095811294,115277,1723,117000,69518,1723,71241,0.975814489,0,45759,0,45759,1,1
92008,73,San Diego,10.40080794,283092,4453,287545,172519,4453,176972,0.974837827,0,110573,0,110573,1,1
92126,73,San Diego,11.58648067,314483,3951,318434,182368,3951,186319,0.978794433,0,132115,0,132115,1,1
91905,73,San Diego,83.57075312,6,2,8,3,2,5,0.6,0,3,0,3,1,1
92036,73,San Diego,504.3106143,26,2,28,8,2,10,0.8,0,18,0,18,1,1
92061,73,San Diego,34.82948708,714,56,770,426,56,482,0.883817427,0,288,0,288,1,1
92124,73,San Diego,9.783878105,83934,1344,85278,47288,1344,48632,0.972363876,0,36646,0,36646,1,1
91901,73,San Diego,77.87352722,15670,624,16294,9004,624,9628,0.935189032,0,6666,0,6666,1,1
92010,73,San Diego,8.242332091,52287,710,52997,32665,710,33375,0.978726592,0,19622,0,19622,1,1
92066,73,San Diego,22.05911671,0,0,0,0,0,0,0,0,0,0,0,0,0
92014,73,San Diego,6.305081908,127019,2799,129818,81173,2799,83972,0.966667461,0,45846,0,45846,1,1
92059,73,San Diego,27.61416249,4710,284,4994,2403,256,2659,0.903723204,0,2307,28,2335,0.988008565,0
92067,73,San Diego,22.39321875,31165,752,31917,22101,752,22853,0.967094036,0,9064,0,9064,1,1
92115,73,San Diego,6.169479453,613302,8581,621883,334481,8581,343062,0.974987029,0,278821,0,278821,1,1
92131,73,San Diego,38.64284207,77633,910,78543,46044,910,46954,0.98061933,0,31589,0,31589,1,1
92672,73,San Diego,35.56343927,209945,14708,224653,94168,3833,98001,0.960888154,0,115777,10875,126652,0.914134795,0
91911,73,San Diego,12.72769312,365198,4901,370099,237184,4901,242085,0.979755045,0,128014,0,128014,1,1
92004,73,San Diego,914.8873018,3,0,3,0,0,0,0,0,3,0,3,1,1
92037,73,San Diego,12.04633217,928101,9935,938036,548936,9935,558871,0.982223089,0,379165,0,379165,1,1
92069,73,San Diego,18.47108549,134514,1807,136321,74515,1807,76322,0.976323996,0,59999,0,59999,1,1
92105,73,San Diego,5.755599048,356442,4482,360924,176241,4482,180723,0.975199615,0,180201,0,180201,1,1
91917,73,San Diego,51.83818755,70,15,85,66,15,81,0.814814815,0,4,0,4,1,1
92025,73,San Diego,22.37264403,186954,3008,189962,97217,3008,100225,0.969987528,0,89737,0,89737,1,1
92084,73,San Diego,28.3417625,114587,1863,116450,58894,1863,60757,0.969336867,0,55693,0,55693,1,1
92106,73,San Diego,5.664076937,320443,3348,323791,189421,3348,192769,0.982632062,0,131022,0,131022,1,1
92108,73,San Diego,4.408199292,747688,9217,756905,423622,9217,432839,0.978705708,0,324066,0,324066,1,1
92109,73,San Diego,7.60901175,1453879,20914,1474793,822631,20914,843545,0.975207013,0,631248,0,631248,1,1
92111,73,San Diego,8.478645548,490126,5444,495570,278081,5444,283525,0.980798871,0,212045,0,212045,1,1
92114,73,San Diego,8.288294693,210299,2639,212938,109305,2639,111944,0.976425713,0,100994,0,100994,1,1
91931,73,San Diego,8.204879996,16,0,16,6,0,6,1,1,10,0,10,1,1
92057,73,San Diego,14.96368091,105571,1205,106776,54474,1205,55679,0.978358088,0,51097,0,51097,1,1
92118,73,San Diego,7.690223723,285733,3171,288904,195759,3171,198930,0.984059719,0,89974,0,89974,1,1
92139,73,San Diego,3.577772433,94226,1238,95464,51164,1238,52402,0.976374948,0,43062,0,43062,1,1
91980,73,San Diego,3.711057105,49,2,51,25,2,27,0.925925926,0,24,0,24,1,1
92009,73,San Diego,12.18511496,126463,1959,128422,80052,1959,82011,0.97611296,0,46411,0,46411,1,1
92007,73,San Diego,2.31267887,76452,1395,77847,47637,1395,49032,0.971549192,0,28815,0,28815,1,1
91941,73,San Diego,8.22336357,118976,1568,120544,64949,1568,66517,0.976427079,0,54027,0,54027,1,1
91948,73,San Diego,34.8852073,3,0,3,3,0,3,1,1,0,0,0,0,0
92003,73,San Diego,15.01565554,4929,143,5072,2882,143,3025,0.952727273,0,2047,0,2047,1,1
92019,73,San Diego,31.73218526,105128,1853,106981,60967,1853,62820,0.970503025,0,44161,0,44161,1,1
92055,73,San Diego,129.8923528,17551,1468,19019,7999,1255,9254,0.86438297,0,9552,213,9765,0.978187404,0
92121,73,San Diego,12.53898128,280749,2642,283391,166979,2642,169621,0.984424098,0,113770,0,113770,1,1
92128,73,San Diego,11.7055876,121121,1709,122830,73602,1709,75311,0.977307432,0,47519,0,47519,1,1
92102,73,San Diego,4.490718614,444883,4394,449277,223172,4394,227566,0.980691316,0,221711,0,221711,1,1
92132,73,San Diego,0.032306873,8620,212,8832,4946,212,5158,0.958898798,0,3674,0,3674,1,1
92134,73,San Diego,0.075077166,21793,151,21944,12274,151,12425,0.987847082,0,9519,0,9519,1,1
91910,73,San Diego,12.58674931,435620,6121,441741,275886,6121,282007,0.978294865,0,159734,0,159734,1,1
92026,73,San Diego,36.05862856,85210,1397,86607,46831,1397,48228,0.971033425,0,38379,0,38379,1,1
92103,73,San Diego,3.68480473,814476,8733,823209,409245,8733,417978,0.979106556,0,405231,0,405231,1,1
92104,73,San Diego,3.69456853,717255,6202,723457,342231,6202,348433,0.982200308,0,375024,0,375024,1,1
91914,73,San Diego,6.644138046,34162,549,34711,20317,549,20866,0.973689255,0,13845,0,13845,1,1
91915,73,San Diego,7.729011739,77159,1237,78396,46655,1237,47892,0.974171052,0,30504,0,30504,1,1
91916,73,San Diego,61.90156446,114,11,125,55,11,66,0.833333333,0,59,0,59,1,1
91934,73,San Diego,51.45679857,2,0,2,1,0,1,1,1,1,0,1,1,1
91942,73,San Diego,5.770225056,286848,3829,290677,146591,3829,150420,0.974544608,0,140257,0,140257,1,1
92028,73,San Diego,116.6926378,23366,1021,24387,11465,902,12367,0.927063961,0,11901,119,12020,0.990099834,0
92029,73,San Diego,22.55973733,80329,1265,81594,44921,1265,46186,0.972610748,0,35408,0,35408,1,1
92064,73,San Diego,42.33683878,105430,1786,107216,62422,1786,64208,0.972184152,0,43008,0,43008,1,1
92107,73,San Diego,3.024301118,402130,4475,406605,209649,4475,214124,0.979100895,0,192481,0,192481,1,1
91978,73,San Diego,11.93956706,22997,335,23332,11777,335,12112,0.97234148,0,11220,0,11220,1,1
91977,73,San Diego,9.917851587,197256,3003,200259,106280,3003,109283,0.972520886,0,90976,0,90976,1,1
91935,73,San Diego,105.4900322,9055,283,9338,5264,283,5547,0.948981431,0,3791,0,3791,1,1
92040,73,San Diego,67.19631084,69457,1321,70778,38081,1321,39402,0.966473783,0,31376,0,31376,1,1
92054,73,San Diego,7.47208573,288636,4256,292892,162147,4238,166385,0.974528954,0,126489,18,126507,0.999857715,0
92110,73,San Diego,5.006871039,793828,9907,803735,460353,9907,470260,0.978932931,0,333475,0,333475,1,1
92056,73,San Diego,12.30973778,166568,2124,168692,92877,2124,95001,0.977642341,0,73691,0,73691,1,1
92058,73,San Diego,44.2653244,91093,1516,92609,41959,1516,43475,0.965129385,0,49134,0,49134,1,1
92060,73,San Diego,68.86668704,0,0,0,0,0,0,0,0,0,0,0,0,0
92113,73,San Diego,4.510523823,489028,5594,494622,282119,5594,287713,0.980557013,0,206909,0,206909,1,1
91945,73,San Diego,3.952929688,131404,1754,133158,66905,1754,68659,0.974453458,0,64499,0,64499,1,1
91950,73,San Diego,7.33744815,420534,5203,425737,252761,5203,257964,0.979830519,0,167773,0,167773,1,1
92082,73,San Diego,125.6836921,8076,450,8526,4902,450,5352,0.915919283,0,3174,0,3174,1,1
92083,73,San Diego,5.547147634,131813,1739,133552,66304,1739,68043,0.974442632,0,65509,0,65509,1,1
92075,73,San Diego,3.418511065,122471,2035,124506,75406,2035,77441,0.97372193,0,47065,0,47065,1,1
92070,73,San Diego,129.4157224,10,1,11,7,1,8,0.875,0,3,0,3,1,1
91902,73,San Diego,11.21699374,84684,1382,86066,53265,1382,54647,0.974710414,0,31419,0,31419,1,1
91962,73,San Diego,58.66470996,111,12,123,78,12,90,0.866666667,0,33,0,33,1,1
91963,73,San Diego,41.24718898,5,0,5,0,0,0,0,0,5,0,5,1,1
92065,73,San Diego,169.3495513,7276,524,7800,4091,524,4615,0.886457205,0,3185,0,3185,1,1
92116,73,San Diego,3.379834247,397062,2915,399977,184760,2915,187675,0.98446783,0,212302,0,212302,1,1
92071,73,San Diego,18.84916092,151050,2277,153327,85328,2277,87605,0.974008333,0,65722,0,65722,1,1
92117,73,San Diego,8.702990164,353513,4087,357600,196727,4087,200814,0.979647833,0,156786,0,156786,1,1
92011,73,San Diego,6.537145131,112098,1321,113419,70217,1321,71538,0.981534289,0,41881,0,41881,1,1
92078,73,San Diego,16.70031644,156935,2237,159172,92243,2237,94480,0.976323031,0,64692,0,64692,1,1
92081,73,San Diego,8.935654165,95145,1418,96563,52771,1418,54189,0.973832328,0,42374,0,42374,1,1
92119,73,San Diego,6.564557748,64872,748,65620,35483,748,36231,0.979354696,0,29389,0,29389,1,1
92120,73,San Diego,7.680557222,179454,2405,181859,94962,2405,97367,0.97529964,0,84492,0,84492,1,1
92020,73,San Diego,11.11618274,285091,3917,289008,153100,3917,157017,0.975053657,0,131991,0,131991,1,1
92122,73,San Diego,5.378200073,545277,5917,551194,306516,5917,312433,0.98106154,0,238761,0,238761,1,1
92123,73,San Diego,8.611394693,326019,3740,329759,181708,3740,185448,0.979832622,0,144311,0,144311,1,1
92129,73,San Diego,13.08406333,94989,1405,96394,55150,1405,56555,0.975156927,0,39839,0,39839,1,1
91932,73,San Diego,4.276725834,99287,1517,100804,62900,1517,64417,0.976450316,0,36387,0,36387,1,1
92091,73,San Diego,1.290287627,4924,68,4992,3337,68,3405,0.980029369,0,1587,0,1587,1,1
91906,73,San Diego,105.1500444,41,4,45,30,4,34,0.882352941,0,11,0,11,1,1
92021,73,San Diego,28.03920671,198430,3028,201458,107864,3028,110892,0.972694153,0,90566,0,90566,1,1
92101,73,San Diego,5.383709006,4955311,64524,5019835,2903009,64524,2967533,0.978256687,0,2052302,0,2052302,1,1
92086,73,San Diego,221.351506,4,0,4,1,0,1,1,1,3,0,3,1,1
92127,73,San Diego,22.6745531,103378,1468,104846,63171,1468,64639,0.977289253,0,40207,0,40207,1,1
92130,73,San Diego,18.56433272,242927,3180,246107,155086,3180,158266,0.979907245,0,87841,0,87841,1,1
92024,73,San Diego,18.02519822,276646,4878,281524,166692,4878,171570,0.971568456,0,109954,0,109954,1,1
92027,73,San Diego,59.66901377,100363,1316,101679,55507,1316,56823,0.976840364,0,44856,0,44856,1,1
92140,73,San Diego,0.535153379,5237,202,5439,3695,202,3897,0.948165255,0,1542,0,1542,1,1
92147,73,San Diego,0.087039828,9097,63,9160,5551,63,5614,0.988778055,0,3546,0,3546,1,1
92155,73,San Diego,0.392899124,7982,59,8041,5455,59,5514,0.989299964,0,2527,0,2527,1,1
92135,73,San Diego,0.420668501,1460,40,1500,1115,40,1155,0.965367965,0,345,0,345,1,1
92145,73,San Diego,10.64186507,2726,34,2760,1754,34,1788,0.98098434,0,972,0,972,1,1
92154,73,San Diego,51.30323417,407251,5890,413141,283823,5890,289713,0.979669535,0,123428,0,123428,1,1
92173,73,San Diego,2.877433304,321550,4448,325998,239064,4448,243512,0.98173396,0,82486,0,82486,1,1
92179,73,San Diego,0.250121697,0,0,0,0,0,0,0,0,0,0,0,0,0
92096,73,San Diego,0.326548682,0,0,0,0,0,0,0,0,0,0,0,0,0
92182,73,San Diego,0.208879603,0,0,0,0,0,0,0,0,0,0,0,0,0
92092,73,San Diego,0.133328302,0,0,0,0,0,0,0,0,0,0,0,0,0
92136,73,San Diego,0.952340766,0,0,0,0,0,0,0,0,0,0,0,0,0
92093,73,San Diego,0.88900657,0,0,0,0,0,0,0,0,0,0,0,0,0
92161,73,San Diego,0.087749102,0,0,0,0,0,0,0,0,0,0,0,0,0
92257,25,Imperial,270.6728023,5,0,5,5,0,5,1,1,0,0,0,0,0
92273,25,Imperial,3.231752136,161,7,168,120,7,127,0.94488189,0,41,0,41,1,1
92259,25,Imperial,287.9069026,9,0,9,5,0,5,1,1,4,0,4,1,1
92243,25,Imperial,113.2935925,40619,878,41497,35287,878,36165,0.975722384,0,5332,0,5332,1,1
92249,25,Imperial,19.86182311,2502,37,2539,2250,37,2287,0.9838216,0,252,0,252,1,1
92266,25,Imperial,1184.956031,0,0,0,0,0,0,0,0,0,0,0,0,0
92275,25,Imperial,40.54466759,11,0,11,8,0,8,1,1,3,0,3,1,1
92281,25,Imperial,13.19544316,42,3,45,39,3,42,0.928571429,0,3,0,3,1,1
92283,25,Imperial,332.0896147,25,0,25,9,0,9,1,1,16,0,16,1,1
92222,25,Imperial,2.759264607,0,0,0,0,0,0,0,0,0,0,0,0,0
92227,25,Imperial,593.6688683,2051,125,2176,1885,125,2010,0.937810945,0,166,0,166,1,1
92233,25,Imperial,152.0526214,22,0,22,22,0,22,1,1,0,0,0,0,0
92231,25,Imperial,68.55337671,12799,373,13172,11850,373,12223,0.96948376,0,949,0,949,1,1
92250,25,Imperial,352.3832998,653,24,677,564,24,588,0.959183673,0,89,0,89,1,1
92251,25,Imperial,247.3689038,11783,246,12029,10544,246,10790,0.977201112,0,1239,0,1239,1,1
92501,65,Riverside,5.638636153,148087,9521,157608,74486,3896,78382,0.950294711,0,73601,5625,79226,0.929000581,0
92505,65,Riverside,10.17653012,101376,6569,107945,47602,2397,49999,0.952059041,0,53774,4172,57946,0.928001933,0
92211,65,Riverside,14.82492901,54482,2510,56992,33371,914,34285,0.973341111,0,21111,1596,22707,0.929713304,0
92270,65,Riverside,25.62558981,107475,4532,112007,72829,2125,74954,0.971649278,0,34646,2407,37053,0.935038998,0
92561,65,Riverside,163.8541262,16,4,20,14,4,18,0.777777778,0,2,0,2,1,1
92230,65,Riverside,11.67661435,13384,1455,14839,7821,566,8387,0.932514606,0,5563,889,6452,0.862213267,0
92543,65,Riverside,19.14322319,64316,5016,69332,33330,3097,36427,0.914980646,0,30986,1919,32905,0.941680596,0
92549,65,Riverside,106.0357274,242,23,265,227,19,246,0.922764228,0,15,4,19,0.789473684,0
92262,65,Riverside,35.10788626,528270,16476,544746,331079,7815,338894,0.976939692,0,197191,8661,205852,0.957926083,0
92591,65,Riverside,17.22521528,138810,5906,144716,67365,2201,69566,0.968360981,0,71445,3705,75150,0.950698603,0
92241,65,Riverside,132.5675286,4819,616,5435,2612,270,2882,0.906315059,0,2207,346,2553,0.864473169,0
92562,65,Riverside,110.3478941,121871,6459,128330,62476,2492,64968,0.961642655,0,59395,3967,63362,0.937391496,0
92236,65,Riverside,61.85741114,33306,2669,35975,18395,1008,19403,0.948049271,0,14911,1661,16572,0.899770698,0
92539,65,Riverside,130.2559126,10,5,15,8,3,11,0.727272727,0,2,2,4,0.5,0
92587,65,Riverside,7.153831336,11663,1274,12937,5874,429,6303,0.931937173,0,5789,845,6634,0.872625867,0
92592,65,Riverside,110.1582506,168592,8414,177006,93617,3482,97099,0.964139692,0,74975,4932,79907,0.938278248,0
92880,65,Riverside,26.16590501,105507,6278,111785,51879,1830,53709,0.965927498,0,53628,4448,58076,0.923410703,0
92223,65,Riverside,44.99081821,41152,3965,45117,19783,1461,21244,0.931227641,0,21369,2504,23873,0.895111632,0
92239,65,Riverside,517.0219204,1,0,1,1,0,1,1,1,0,0,0,0,0
92532,65,Riverside,15.24309247,28762,2405,31167,11613,672,12285,0.945299145,0,17149,1733,18882,0.908219468,0
92570,65,Riverside,106.2682412,49159,5198,54357,23110,1726,24836,0.930504107,0,26049,3472,29521,0.882388808,0
92596,65,Riverside,57.9408208,23563,1615,25178,11426,578,12004,0.951849384,0,12137,1037,13174,0.921284348,0
92282,65,Riverside,75.48982527,1088,185,1273,655,71,726,0.902203857,0,433,114,547,0.791590494,0
92553,65,Riverside,10.25798727,175017,10499,185516,68957,3304,72261,0.954276858,0,106060,7195,113255,0.936470796,0
92585,65,Riverside,17.10513923,20003,2083,22086,9659,836,10495,0.92034302,0,10344,1247,11591,0.89241653,0
91752,65,Riverside,15.08207008,91270,6464,97734,41423,1727,43150,0.959976825,0,49847,4737,54584,0.913216327,0
92595,65,Riverside,21.52910778,34642,2479,37121,16842,984,17826,0.944799731,0,17800,1495,19295,0.922518787,0
92201,65,Riverside,16.21268861,89864,5527,95391,48557,2327,50884,0.954268532,0,41307,3200,44507,0.928101198,0
92203,65,Riverside,18.45585832,38471,2501,40972,20392,849,21241,0.96003013,0,18079,1652,19731,0.916273884,0
92210,65,Riverside,14.33528649,50006,1584,51590,37036,901,37937,0.976250099,0,12970,683,13653,0.949974365,0
92220,65,Riverside,141.338458,33979,3425,37404,18494,1660,20154,0.917634217,0,15485,1765,17250,0.897681159,0
92225,65,Riverside,580.9740442,59,2,61,28,1,29,0.965517241,0,31,1,32,0.96875,0
92320,65,Riverside,13.94839437,6216,808,7024,2454,334,2788,0.880200861,0,3762,474,4236,0.888101983,0
92879,65,Riverside,9.827613658,105213,6237,111450,51336,2266,53602,0.957725458,0,53877,3971,57848,0.931354584,0
92860,65,Riverside,14.11717205,57410,3819,61229,31432,1461,32893,0.955583255,0,25978,2358,28336,0.916784303,0
92234,65,Riverside,14.76362533,134131,6394,140525,72760,2410,75170,0.967939338,0,61371,3984,65355,0.939040624,0
92240,65,Riverside,35.70817695,43442,4900,48342,21669,2068,23737,0.912878628,0,21773,2832,24605,0.884901443,0
92881,65,Riverside,32.44383454,56167,3537,59704,29448,1167,30615,0.961881431,0,26719,2370,29089,0.918525903,0
92882,65,Riverside,11.75220581,117380,7944,125324,59078,2369,61447,0.96144645,0,58302,5575,63877,0.912722889,0
92883,65,Riverside,56.45029381,34383,3387,37770,17702,1057,18759,0.943653713,0,16681,2330,19011,0.877439377,0
92253,65,Riverside,40.43883801,102144,4295,106439,66763,1763,68526,0.974272539,0,35381,2532,37913,0.93321552,0
92254,65,Riverside,47.88658683,778,135,913,585,90,675,0.866666667,0,193,45,238,0.81092437,0
92258,65,Riverside,10.38399311,4514,464,4978,2595,260,2855,0.908931699,0,1919,204,2123,0.903909562,0
92260,65,Riverside,31.32821847,171380,6386,177766,114486,3131,117617,0.973379699,0,56894,3255,60149,0.945884387,0
92264,65,Riverside,50.90329096,201335,5724,207059,121449,2431,123880,0.98037617,0,79886,3293,83179,0.960410681,0
92503,65,Riverside,34.32725718,168870,10268,179138,79134,3454,82588,0.958177944,0,89736,6814,96550,0.929425168,0
92504,65,Riverside,22.68046783,112254,6717,118971,56213,2302,58515,0.96065966,0,56041,4415,60456,0.926971682,0
92506,65,Riverside,16.2084044,107998,5881,113879,51528,1986,53514,0.962888216,0,56470,3895,60365,0.935475855,0
92509,65,Riverside,30.71804931,109038,8125,117163,49659,2570,52229,0.95079362,0,59379,5555,64934,0.914451597,0
92563,65,Riverside,22.63075152,90214,4615,94829,42303,1616,43919,0.963204991,0,47911,2999,50910,0.941092123,0
92582,65,Riverside,18.41272934,15865,1227,17092,7350,608,7958,0.923598894,0,8515,619,9134,0.932231224,0
92518,65,Riverside,7.84652406,11636,899,12535,4665,194,4859,0.960074089,0,6971,705,7676,0.908155289,0
92507,65,Riverside,21.41123021,312403,15921,328324,140864,4790,145654,0.967113845,0,171539,11131,182670,0.939064981,0
92508,65,Riverside,10.98886723,41217,3137,44354,20133,952,21085,0.954849419,0,21084,2185,23269,0.906098242,0
92530,65,Riverside,77.10256232,70740,6262,77002,30461,2372,32833,0.927755612,0,40279,3890,44169,0.911929181,0
92536,65,Riverside,107.4805914,261,45,306,209,27,236,0.88559322,0,52,18,70,0.742857143,0
92544,65,Riverside,170.7708738,43562,3406,46968,21644,1989,23633,0.915838023,0,21918,1417,23335,0.939275766,0
92545,65,Riverside,29.73561135,55763,4261,60024,26174,1974,28148,0.929870684,0,29589,2287,31876,0.928253231,0
92548,65,Riverside,13.0811077,2934,373,3307,1575,172,1747,0.901545507,0,1359,201,1560,0.871153846,0
92274,65,Riverside,216.1640089,3855,406,4261,2545,187,2732,0.931551977,0,1310,219,1529,0.85676913,0
92276,65,Riverside,37.04341558,12273,942,13215,6519,358,6877,0.947942417,0,5754,584,6338,0.907857368,0
92551,65,Riverside,6.151662294,57933,3706,61639,19864,857,20721,0.958640992,0,38069,2849,40918,0.930372941,0
92555,65,Riverside,65.76332378,74170,5337,79507,30467,1622,32089,0.949453084,0,43703,3715,47418,0.921654224,0
92557,65,Riverside,17.76928959,84624,5783,90407,34237,1628,35865,0.954607556,0,50387,4155,54542,0.923820175,0
92567,65,Riverside,33.119441,3754,424,4178,1979,138,2117,0.934813415,0,1775,286,2061,0.861232411,0
92571,65,Riverside,39.11160215,74792,6138,80930,29428,1645,31073,0.947060149,0,45364,4493,49857,0.909882263,0
92583,65,Riverside,29.14098713,46769,3830,50599,20971,2066,23037,0.910318184,0,25798,1764,27562,0.935998839,0
92584,65,Riverside,29.10585552,54261,4257,58518,24118,1311,25429,0.948444689,0,30143,2946,33089,0.910967391,0
92586,65,Riverside,6.449456647,28198,2394,30592,13994,1063,15057,0.929401607,0,14204,1331,15535,0.914322498,0
92590,65,Riverside,54.3701438,99928,5244,105172,55356,2373,57729,0.958894143,0,44572,2871,47443,0.939485277,0
92521,65,Riverside,0.715032706,0,0,0,0,0,0,0,0,0,0,0,0,0
92630,59,Orange,10.53768647,217805,10049,227854,129313,3215,132528,0.975740975,0,88492,6834,95326,0.928309171,0
92656,59,Orange,7.998377635,154143,8184,162327,90150,2424,92574,0.973815542,0,63993,5760,69753,0.917422907,0
92692,59,Orange,8.594141247,110508,5501,116009,64780,1580,66360,0.976190476,0,45728,3921,49649,0.9210256,0
92802,59,Orange,4.552854729,1236945,40479,1277424,790193,15275,805468,0.98103587,0,446752,25204,471956,0.946596717,0
92886,59,Orange,12.9631641,94364,4598,98962,60651,1658,62309,0.973390682,0,33713,2940,36653,0.919788285,0
92620,59,Orange,5.910127166,130628,5032,135660,86429,1867,88296,0.978855214,0,44199,3165,47364,0.933177097,0
92805,59,Orange,6.225264156,477964,15961,493925,266961,5673,272634,0.979191884,0,211003,10288,221291,0.95350918,0
92832,59,Orange,2.895205675,329453,16101,345554,187040,7634,194674,0.960785724,0,142413,8467,150880,0.943882556,0
90631,59,Orange,13.9743591,238509,10012,248521,129173,3032,132205,0.97706592,0,109336,6980,116316,0.939991059,0
90630,59,Orange,6.150158033,174210,5454,179664,101509,1790,103299,0.982671662,0,72701,3664,76365,0.952019904,0
92646,59,Orange,8.050561146,244451,9351,253802,146773,3455,150228,0.977001624,0,97678,5896,103574,0.943074517,0
92627,59,Orange,6.398248822,617973,27649,645622,370972,11050,382022,0.971074964,0,247001,16599,263600,0.93702959,0
92706,59,Orange,3.539889059,166135,5839,171974,88637,1712,90349,0.981051257,0,77498,4127,81625,0.94943951,0
92870,59,Orange,6.72826356,183565,7432,190997,105496,2670,108166,0.975315718,0,78069,4762,82831,0.942509447,0
92651,59,Orange,22.05528115,271913,18853,290766,184926,6849,191775,0.964286273,0,86987,12004,98991,0.878736451,0
92657,59,Orange,8.299244605,75527,4254,79781,55138,1627,56765,0.971337972,0,20389,2627,23016,0.885862009,0
92683,59,Orange,9.720172863,339914,14344,354258,199985,5456,205441,0.973442497,0,139929,8888,148817,0.940275641,0
92606,59,Orange,3.451149601,234968,7814,242782,144844,2604,147448,0.982339537,0,90124,5210,95334,0.945350033,0
92691,59,Orange,8.777167707,188095,9106,197201,110220,2907,113127,0.974303217,0,77875,6199,84074,0.926267336,0
92840,59,Orange,5.148999812,359614,9908,369522,220018,3643,223661,0.983711957,0,139596,6265,145861,0.957048149,0
92867,59,Orange,12.00266341,234965,8139,243104,145029,2988,148017,0.97981313,0,89936,5151,95087,0.945828557,0
92603,59,Orange,9.986810933,53509,2635,56144,35514,805,36319,0.977835293,0,17995,1830,19825,0.907692308,0
92618,59,Orange,20.69212372,516820,19519,536339,326870,6573,333443,0.980287485,0,189950,12946,202896,0.936193912,0
92653,59,Orange,6.926982449,142129,6709,148838,82921,2063,84984,0.975724842,0,59208,4646,63854,0.927240267,0
90620,59,Orange,6.369699514,270331,9642,279973,157859,3135,160994,0.980527225,0,112472,6507,118979,0.945309676,0
90720,59,Orange,6.079101369,95641,4489,100130,56674,1592,58266,0.972677033,0,38967,2897,41864,0.930799732,0
92655,59,Orange,0.90309628,26600,1088,27688,15337,436,15773,0.972357827,0,11263,652,11915,0.94527906,0
92673,59,Orange,10.3048661,82963,5690,88653,35793,1133,36926,0.969317012,0,47170,4557,51727,0.911902875,0
92868,59,Orange,3.439420145,334448,11564,346012,202137,4476,206613,0.97833631,0,132311,7088,139399,0.94915315,0
92703,59,Orange,4.241959479,243100,8903,252003,128088,2802,130890,0.978592711,0,115012,6101,121113,0.949625556,0
92833,59,Orange,7.667103811,192439,6493,198932,113639,2194,115833,0.981058938,0,78800,4299,83099,0.948266525,0
92869,59,Orange,13.47202688,109455,4921,114376,65127,1521,66648,0.97717861,0,44328,3400,47728,0.92876299,0
90742,59,Orange,0.188323036,18395,1265,19660,10596,469,11065,0.957614099,0,7799,796,8595,0.907388016,0
90680,59,Orange,2.552203167,132051,4532,136583,75478,1711,77189,0.977833629,0,56573,2821,59394,0.95250362,0
90740,59,Orange,11.05898103,98889,5769,104658,58815,1890,60705,0.968865827,0,40074,3879,43953,0.911746638,0
90743,59,Orange,0.133498188,1192,103,1295,804,49,853,0.942555686,0,388,54,442,0.877828054,0
90621,59,Orange,4.191333126,219101,7529,226630,129638,2572,132210,0.980546101,0,89463,4957,94420,0.94750053,0
90623,59,Orange,1.814135879,47018,1671,48689,27723,566,28289,0.979992223,0,19295,1105,20400,0.945833333,0
92866,59,Orange,1.906276914,146935,5202,152137,88870,2039,90909,0.977570978,0,58065,3163,61228,0.948340628,0
92602,59,Orange,15.10746955,79439,3155,82594,49662,1086,50748,0.978600142,0,29777,2069,31846,0.935031087,0
92604,59,Orange,3.347630078,137102,4319,141421,87536,1537,89073,0.98274449,0,49566,2782,52348,0.946855658,0
92610,59,Orange,4.040540178,50256,2751,53007,30751,691,31442,0.978023027,0,19505,2060,21565,0.904474843,0
92612,59,Orange,6.395470031,439862,14533,454395,280514,5345,285859,0.981301971,0,159348,9188,168536,0.945483458,0
92614,59,Orange,4.434635452,259532,7910,267442,163799,2881,166680,0.982715383,0,95733,5029,100762,0.950090312,0
92617,59,Orange,2.233697419,182848,6073,188921,108433,1479,109912,0.98654378,0,74415,4594,79009,0.941854725,0
92624,59,Orange,1.502556838,36500,2428,38928,20384,763,21147,0.963919232,0,16116,1665,17781,0.906360722,0
92629,59,Orange,5.061798978,199519,10403,209922,129997,3640,133637,0.972762034,0,69522,6763,76285,0.911345612,0
92637,59,Orange,2.964763483,30020,1994,32014,15513,569,16082,0.964618829,0,14507,1425,15932,0.910557369,0
92647,59,Orange,7.536478238,343656,12305,355961,200369,4456,204825,0.978244843,0,143287,7849,151136,0.948066642,0
92649,59,Orange,5.641010694,142665,6816,149481,85389,2255,87644,0.974270914,0,57276,4561,61837,0.926241571,0
92660,59,Orange,9.606364439,502941,17939,520880,338472,7023,345495,0.979672644,0,164469,10916,175385,0.937759786,0
92661,59,Orange,0.651030163,67031,3983,71014,44203,1444,45647,0.968365939,0,22828,2539,25367,0.899909331,0
92662,59,Orange,0.208266084,24812,1320,26132,17552,513,18065,0.971602546,0,7260,807,8067,0.899962811,0
92675,59,Orange,13.38630946,168245,11594,179839,94463,3253,97716,0.966709648,0,73782,8341,82123,0.898432839,0
92708,59,Orange,9.102882791,243067,9154,252221,140074,3277,143351,0.977140027,0,102993,5877,108870,0.946018187,0
92688,59,Orange,13.22026888,89515,6185,95700,47852,1577,49429,0.968095652,0,41663,4608,46271,0.900412786,0
92804,59,Orange,7.124930674,370706,12358,383064,210954,4782,215736,0.977834019,0,159752,7576,167328,0.954723657,0
92663,59,Orange,3.290919883,544374,28129,572503,358346,12520,370866,0.966241176,0,186028,15609,201637,0.922588612,0
92676,59,Orange,69.44794781,1949,361,2310,1222,106,1328,0.920180723,0,727,255,982,0.740325866,0
92677,59,Orange,16.4464086,195717,11152,206869,117302,3541,120843,0.970697517,0,78415,7611,86026,0.911526748,0
92678,59,Orange,38.14607362,881,71,952,664,20,684,0.970760234,0,217,51,268,0.809701493,0
92679,59,Orange,25.1765469,36641,2814,39455,23484,833,24317,0.96574413,0,13157,1981,15138,0.86913727,0
92694,59,Orange,40.15358547,40264,2337,42601,26037,708,26745,0.973527762,0,14227,1629,15856,0.897262866,0
92701,59,Orange,3.224608438,368932,14682,383614,196045,4718,200763,0.976499654,0,172887,9964,182851,0.945507544,0
92704,59,Orange,7.40718511,430258,15689,445947,233784,4921,238705,0.979384596,0,196474,10768,207242,0.94804142,0
92705,59,Orange,11.78634358,361528,14429,375957,207999,5198,213197,0.975618794,0,153529,9231,162760,0.943284591,0
92707,59,Orange,5.225015596,943408,30536,973944,585663,10785,596448,0.981917954,0,357745,19751,377496,0.947678916,0
92780,59,Orange,6.274392811,356434,13232,369666,202034,4328,206362,0.979027146,0,154400,8904,163304,0.945475922,0
92782,59,Orange,5.169896923,82950,3114,86064,48602,1011,49613,0.979622276,0,34348,2103,36451,0.94230611,0
92801,59,Orange,6.289712649,402045,14064,416109,228711,5027,233738,0.978493014,0,173334,9037,182371,0.950447165,0
92808,59,Orange,5.000130434,35541,2378,37919,22971,839,23810,0.964762705,0,12570,1539,14109,0.890920689,0
92821,59,Orange,14.13130423,197964,7574,205538,119706,2774,122480,0.977351404,0,78258,4800,83058,0.942209059,0
92861,59,Orange,2.090679836,20701,906,21607,13487,348,13835,0.974846404,0,7214,558,7772,0.928203809,0
92843,59,Orange,3.960118174,166837,5956,172793,97875,2311,100186,0.976932905,0,68962,3645,72607,0.949798229,0
92806,59,Orange,7.683234854,401308,17966,419274,233247,6731,239978,0.971951596,0,168061,11235,179296,0.937338256,0
92807,59,Orange,10.95016416,113616,5518,119134,69561,1797,71358,0.974817119,0,44055,3721,47776,0.922115707,0
92823,59,Orange,7.456475156,11663,532,12195,7391,175,7566,0.976870209,0,4272,357,4629,0.922877511,0
92831,59,Orange,5.948929854,294169,9353,303522,170186,3413,173599,0.980339749,0,123983,5940,129923,0.954280612,0
92835,59,Orange,5.72109949,82182,3121,85303,47040,1156,48196,0.976014607,0,35142,1965,37107,0.947045032,0
92841,59,Orange,4.559269076,142215,4456,146671,82182,1613,83795,0.980750641,0,60033,2843,62876,0.954784019,0
92844,59,Orange,2.09977722,93727,3522,97249,55764,1401,57165,0.975491997,0,37963,2121,40084,0.947086119,0
92845,59,Orange,2.227994662,38317,1649,39966,23290,537,23827,0.977462542,0,15027,1112,16139,0.931098581,0
92865,59,Orange,3.828622322,115781,4453,120234,65716,1344,67060,0.979958246,0,50065,3109,53174,0.941531576,0
92887,59,Orange,11.28539555,33842,2295,36137,21714,778,22492,0.965409924,0,12128,1517,13645,0.888823745,0
92625,59,Orange,2.559814823,105870,5083,110953,74433,2378,76811,0.969040893,0,31437,2705,34142,0.92077207,0
92626,59,Orange,9.703673091,695240,25946,721186,428824,10030,438854,0.977145019,0,266416,15916,282332,0.943626652,0
92648,59,Orange,8.046996633,518210,25264,543474,314515,10584,325099,0.967443763,0,203695,14680,218375,0.932776188,0
92697,59,Orange,0.162583022,0,0,0,0,0,0,0,0,0,0,0,0,0
93110,83,Santa Barbara,8.085496615,63562,688,64250,36155,688,36843,0.981326168,0,27407,0,27407,1,1
93109,83,Santa Barbara,3.433064486,98494,1178,99672,58187,1178,59365,0.980156658,0,40307,0,40307,1,1
93454,83,Santa Barbara,418.2871728,37391,775,38166,30673,775,31448,0.975356143,0,6718,0,6718,1,1
93429,83,Santa Barbara,6.901291084,7,1,8,6,1,7,0.857142857,0,1,0,1,1,1
93460,83,Santa Barbara,220.0695386,11345,430,11775,9170,430,9600,0.955208333,0,2175,0,2175,1,1
93013,83,Santa Barbara,41.38086825,21612,503,22115,13995,499,14494,0.965571961,0,7617,4,7621,0.999475134,0
93436,83,Santa Barbara,228.0424187,17531,607,18138,15526,607,16133,0.962375256,0,2005,0,2005,1,1
93437,83,Santa Barbara,49.60986315,364,10,374,340,10,350,0.971428571,0,24,0,24,1,1
93067,83,Santa Barbara,0.580715591,3503,57,3560,2272,57,2329,0.975525977,0,1231,0,1231,1,1
93441,83,Santa Barbara,38.61821906,3794,59,3853,2887,59,2946,0.979972845,0,907,0,907,1,1
93427,83,Santa Barbara,69.47705659,9517,176,9693,7185,176,7361,0.976090205,0,2332,0,2332,1,1
93434,83,Santa Barbara,22.80567018,754,16,770,519,16,535,0.970093458,0,235,0,235,1,1
93440,83,Santa Barbara,44.0900652,840,44,884,699,44,743,0.940780619,0,141,0,141,1,1
93463,83,Santa Barbara,33.89921332,13914,283,14197,10778,283,11061,0.97441461,0,3136,0,3136,1,1
93455,83,Santa Barbara,118.3274271,25859,627,26486,21990,627,22617,0.97227749,0,3869,0,3869,1,1
93458,83,Santa Barbara,28.41555085,23638,426,24064,19735,426,20161,0.978870096,0,3903,0,3903,1,1
93101,83,Santa Barbara,3.202376952,551622,6846,558468,317121,6846,323967,0.978868218,0,234501,0,234501,1,1
93103,83,Santa Barbara,5.489535886,149401,1545,150946,86214,1545,87759,0.982394968,0,63187,0,63187,1,1
93111,83,Santa Barbara,8.135102495,54036,552,54588,31239,552,31791,0.982636595,0,22797,0,22797,1,1
93105,83,Santa Barbara,139.7556274,154157,1657,155814,89908,1657,91565,0.981903566,0,64249,0,64249,1,1
93108,83,Santa Barbara,27.85849803,58708,928,59636,41361,928,42289,0.978055759,0,17347,0,17347,1,1
93117,83,Santa Barbara,168.0803365,440364,3491,443855,261722,3491,265213,0.986836995,0,178642,0,178642,1,1
93254,83,Santa Barbara,200.9212138,12,0,12,12,0,12,1,1,0,0,0,0,0
93106,83,Santa Barbara,0.62840485,0,0,0,0,0,0,0,0,0,0,0,0,0
93218,107,Tulare,65.64816129,2,0,2,2,0,2,1,1,0,0,0,0,0
93291,107,Tulare,84.19762629,67468,1988,69456,45507,1988,47495,0.958142962,0,21961,0,21961,1,1
93646,107,Tulare,34.29316766,56,2,58,18,2,20,0.9,0,38,0,38,1,1
93647,107,Tulare,93.12639236,153,11,164,88,11,99,0.888888889,0,65,0,65,1,1
93271,107,Tulare,152.4143681,1,1,2,0,1,1,0,0,1,0,1,1,1
93292,107,Tulare,114.7456763,38679,1084,39763,25571,1084,26655,0.959332208,0,13108,0,13108,1,1
93257,107,Tulare,378.8729975,1307,47,1354,292,47,339,0.861356932,0,1015,0,1015,1,1
93633,107,Tulare,4.840760571,0,0,0,0,0,0,0,0,0,0,0,0,0
93223,107,Tulare,3.102881792,2612,86,2698,1473,86,1559,0.944836434,0,1139,0,1139,1,1
93235,107,Tulare,4.148845847,526,20,546,354,20,374,0.946524064,0,172,0,172,1,1
93258,107,Tulare,0.975305851,8,2,10,1,2,3,0.333333333,0,7,0,7,1,1
93261,107,Tulare,5.775515841,0,1,1,0,1,1,0,0,0,0,0,0,0
93603,107,Tulare,107.6802728,0,0,0,0,0,0,0,0,0,0,0,0,0
93615,107,Tulare,16.09081408,186,12,198,115,12,127,0.905511811,0,71,0,71,1,1
93618,107,Tulare,66.90261846,1111,117,1228,563,117,680,0.827941176,0,548,0,548,1,1
93631,107,Tulare,82.54155332,1379,119,1498,685,119,804,0.85199005,0,694,0,694,1,1
93666,107,Tulare,0.211670364,5,0,5,3,0,3,1,1,2,0,2,1,1
93673,107,Tulare,0.778792389,62,5,67,46,5,51,0.901960784,0,16,0,16,1,1
93201,107,Tulare,71.73712993,0,0,0,0,0,0,0,0,0,0,0,0,0
93207,107,Tulare,52.39150867,0,0,0,0,0,0,0,0,0,0,0,0,0
93208,107,Tulare,7.705480626,0,0,0,0,0,0,0,0,0,0,0,0,0
93219,107,Tulare,102.9259212,21,1,22,2,1,3,0.666666667,0,19,0,19,1,1
93221,107,Tulare,132.0657052,2840,120,2960,1858,120,1978,0.939332659,0,982,0,982,1,1
93238,107,Tulare,109.6165319,86,9,95,84,9,93,0.903225806,0,2,0,2,1,1
93247,107,Tulare,65.78723366,297,25,322,191,25,216,0.884259259,0,106,0,106,1,1
93262,107,Tulare,262.4352182,0,0,0,0,0,0,0,0,0,0,0,0,0
93270,107,Tulare,67.43625792,25,3,28,7,3,10,0.7,0,18,0,18,1,1
93272,107,Tulare,83.97605506,200,9,209,145,9,154,0.941558442,0,55,0,55,1,1
93244,107,Tulare,7.850560392,20,1,21,17,1,18,0.944444444,0,3,0,3,1,1
93256,107,Tulare,74.63179043,97,3,100,81,3,84,0.964285714,0,16,0,16,1,1
93260,107,Tulare,37.22488373,0,0,0,0,0,0,0,0,0,0,0,0,0
93265,107,Tulare,389.6799896,0,0,0,0,0,0,0,0,0,0,0,0,0
93267,107,Tulare,61.72760759,45,4,49,17,4,21,0.80952381,0,28,0,28,1,1
93274,107,Tulare,219.2421206,27262,1138,28400,17737,1138,18875,0.939708609,0,9525,0,9525,1,1
93277,107,Tulare,39.42822757,67307,1349,68656,42978,1349,44327,0.969567081,0,24329,0,24329,1,1
93286,107,Tulare,72.58533225,315,34,349,199,34,233,0.854077253,0,116,0,116,1,1
93670,107,Tulare,0.046631334,0,0,0,0,0,0,0,0,0,0,0,0,0
93227,107,Tulare,0.093842596,0,0,0,0,0,0,0,0,0,0,0,0,0
93237,107,Tulare,4.528438666,0,0,0,0,0,0,0,0,0,0,0,0,0
93442,79,San Luis Obispo,44.54164365,9328,314,9642,7209,314,7523,0.958261332,0,2119,0,2119,1,1
93424,79,San Luis Obispo,20.14360998,4692,64,4756,3392,64,3456,0.981481481,0,1300,0,1300,1,1
93445,79,San Luis Obispo,17.02127897,7074,114,7188,5217,114,5331,0.978615644,0,1857,0,1857,1,1
93452,79,San Luis Obispo,114.1641599,71,0,71,66,0,66,1,1,5,0,5,1,1
93420,79,San Luis Obispo,197.4303356,27301,643,27944,20528,643,21171,0.969628265,0,6773,0,6773,1,1
93465,79,San Luis Obispo,84.63718262,6020,86,6106,4107,86,4193,0.979489626,0,1913,0,1913,1,1
93461,79,San Luis Obispo,294.2114683,16,0,16,14,0,14,1,1,2,0,2,1,1
93401,79,San Luis Obispo,64.17337306,229161,3249,232410,164306,3249,167555,0.980609352,0,64855,0,64855,1,1
93405,79,San Luis Obispo,89.71914357,203760,1927,205687,146438,1927,148365,0.987011762,0,57322,0,57322,1,1
93410,79,San Luis Obispo,0.43612888,2753,14,2767,1954,14,1968,0.992886179,0,799,0,799,1,1
93433,79,San Luis Obispo,2.164296756,15556,263,15819,11482,263,11745,0.977607493,0,4074,0,4074,1,1
93402,79,San Luis Obispo,27.7476128,3333,94,3427,2294,94,2388,0.960636516,0,1039,0,1039,1,1
93428,79,San Luis Obispo,77.28096981,1331,28,1359,1208,28,1236,0.977346278,0,123,0,123,1,1
93453,79,San Luis Obispo,691.3868258,541,17,558,372,17,389,0.956298201,0,169,0,169,1,1
93422,79,San Luis Obispo,68.79439871,20683,697,21380,15101,697,15798,0.955880491,0,5582,0,5582,1,1
93430,79,San Luis Obispo,71.74406861,1532,41,1573,1267,41,1308,0.968654434,0,265,0,265,1,1
93432,79,San Luis Obispo,84.53577856,55,2,57,41,2,43,0.953488372,0,14,0,14,1,1
93444,79,San Luis Obispo,65.39800253,4797,162,4959,3476,162,3638,0.955470038,0,1321,0,1321,1,1
93446,79,San Luis Obispo,428.3400114,93575,1237,94812,65815,1237,67052,0.981551632,0,27760,0,27760,1,1
93449,79,San Luis Obispo,9.907273107,41588,767,42355,30219,767,30986,0.975246886,0,11369,0,11369,1,1
93408,79,San Luis Obispo,0.021534183,0,0,0,0,0,0,0,0,0,0,0,0,0
93407,79,San Luis Obispo,0.851195011,0,0,0,0,0,0,0,0,0,0,0,0,0
93409,79,San Luis Obispo,0.399594168,0,0,0,0,0,0,0,0,0,0,0,0,0
93614,39,Madera,128.4650256,112,3,115,43,3,46,0.934782609,0,69,0,69,1,1
93644,39,Madera,117.1242006,50,6,56,19,6,25,0.76,0,31,0,31,1,1
93601,39,Madera,39.61974022,2,0,2,1,0,1,1,1,1,0,1,1,1
93637,39,Madera,280.4153271,5895,316,6211,2462,316,2778,0.8862491,0,3433,0,3433,1,1
93669,39,Madera,7.072225923,0,1,1,0,1,1,0,0,0,0,0,0,0
93653,39,Madera,213.9515229,0,0,0,0,0,0,0,0,0,0,0,0,0
93604,39,Madera,44.43490054,5,0,5,4,0,4,1,1,1,0,1,1,1
93610,39,Madera,263.1654611,233,22,255,89,22,111,0.801801802,0,144,0,144,1,1
93645,39,Madera,59.69509394,0,0,0,0,0,0,0,0,0,0,0,0,0
93638,39,Madera,90.26325572,3529,162,3691,1207,162,1369,0.881665449,0,2322,0,2322,1,1
93626,39,Madera,99.49238412,969,74,1043,553,74,627,0.881977671,0,416,0,416,1,1
93636,39,Madera,197.5326111,5137,204,5341,2694,204,2898,0.929606625,0,2443,0,2443,1,1
93643,39,Madera,152.496906,2,0,2,1,0,1,1,1,1,0,1,1,1
93660,19,Fresno,48.75772604,10,0,10,8,0,8,1,1,2,0,2,1,1
93662,19,Fresno,77.86120162,5044,273,5317,2457,273,2730,0.9,0,2587,0,2587,1,1
93627,19,Fresno,62.35359697,0,0,0,0,0,0,0,0,0,0,0,0,0
93648,19,Fresno,22.11712692,929,54,983,418,54,472,0.88559322,0,511,0,511,1,1
93668,19,Fresno,47.56936179,1,0,1,1,0,1,1,1,0,0,0,0,0
93728,19,Fresno,3.042186231,76316,1828,78144,35829,1828,37657,0.951456568,0,40487,0,40487,1,1
93657,19,Fresno,225.8140479,8184,381,8565,4646,381,5027,0.92420927,0,3538,0,3538,1,1
93737,19,Fresno,9.762538905,0,0,0,0,0,0,0,0,0,0,0,0,0
93651,19,Fresno,16.28345415,4,0,4,3,0,3,1,1,1,0,1,1,1
93619,19,Fresno,186.5226765,35383,929,36312,21545,929,22474,0.958663344,0,13838,0,13838,1,1
93664,19,Fresno,188.1242154,0,0,0,0,0,0,0,0,0,0,0,0,0
93630,19,Fresno,162.2210642,800,70,870,419,70,489,0.856850716,0,381,0,381,1,1
93730,19,Fresno,7.868831609,26673,979,27652,16653,979,17632,0.944475953,0,10020,0,10020,1,1
93667,19,Fresno,117.7486054,0,0,0,0,0,0,0,0,0,0,0,0,0
93675,19,Fresno,99.29780542,2,0,2,0,0,0,0,0,2,0,2,1,1
93703,19,Fresno,4.760983746,74016,1097,75113,31098,1097,32195,0.965926386,0,42918,0,42918,1,1
93704,19,Fresno,5.396714149,93276,1294,94570,42724,1294,44018,0.970602935,0,50552,0,50552,1,1
93711,19,Fresno,11.21598755,105576,1921,107497,55533,1921,57454,0.966564556,0,50043,0,50043,1,1
93721,19,Fresno,2.040922217,82815,1338,84153,39874,1338,41212,0.967533728,0,42941,0,42941,1,1
93602,19,Fresno,111.0380756,2,0,2,1,0,1,1,1,1,0,1,1,1
93605,19,Fresno,14.85817913,0,0,0,0,0,0,0,0,0,0,0,0,0
93606,19,Fresno,0.692100826,89,2,91,44,2,46,0.956521739,0,45,0,45,1,1
93616,19,Fresno,13.77744332,395,21,416,193,21,214,0.901869159,0,202,0,202,1,1
93628,19,Fresno,62.7213279,0,0,0,0,0,0,0,0,0,0,0,0,0
93650,19,Fresno,0.624922964,14963,202,15165,6954,202,7156,0.97177194,0,8009,0,8009,1,1
93702,19,Fresno,5.170419321,68116,1189,69305,31290,1189,32479,0.96339173,0,36826,0,36826,1,1
93609,19,Fresno,60.97429729,199,31,230,129,31,160,0.80625,0,70,0,70,1,1
93608,19,Fresno,118.4063325,2,0,2,2,0,2,1,1,0,0,0,0,0
93611,19,Fresno,10.30331628,74930,1392,76322,40824,1392,42216,0.96702672,0,34106,0,34106,1,1
93612,19,Fresno,6.748526688,142172,2521,144693,70241,2521,72762,0.965352794,0,71931,0,71931,1,1
93621,19,Fresno,76.44868579,0,0,0,0,0,0,0,0,0,0,0,0,0
93622,19,Fresno,455.3506095,6,2,8,1,2,3,0.333333333,0,5,0,5,1,1
93624,19,Fresno,144.1361689,0,0,0,0,0,0,0,0,0,0,0,0,0
93625,19,Fresno,23.97383425,3575,118,3693,1992,118,2110,0.944075829,0,1583,0,1583,1,1
93634,19,Fresno,1162.280907,0,0,0,0,0,0,0,0,0,0,0,0,0
93640,19,Fresno,157.9298884,14,0,14,1,0,1,1,1,13,0,13,1,1
93641,19,Fresno,63.24746266,0,0,0,0,0,0,0,0,0,0,0,0,0
93652,19,Fresno,2.064498118,15,1,16,6,1,7,0.857142857,0,9,0,9,1,1
93654,19,Fresno,100.5048942,1384,132,1516,660,132,792,0.833333333,0,724,0,724,1,1
93656,19,Fresno,113.2223559,120,12,132,76,12,88,0.863636364,0,44,0,44,1,1
93701,19,Fresno,1.520912612,35778,561,36339,13392,561,13953,0.959793593,0,22386,0,22386,1,1
93705,19,Fresno,4.864938408,76492,1195,77687,31201,1195,32396,0.96311273,0,45291,0,45291,1,1
93706,19,Fresno,158.4882687,66947,1384,68331,27655,1384,29039,0.952339957,0,39292,0,39292,1,1
93722,19,Fresno,19.29959573,134973,2554,137527,63759,2554,66313,0.961485682,0,71214,0,71214,1,1
93725,19,Fresno,67.00097345,47119,859,47978,23013,859,23872,0.964016421,0,24106,0,24106,1,1
93710,19,Fresno,6.172594927,194521,2965,197486,89707,2965,92672,0.968005439,0,104814,0,104814,1,1
93720,19,Fresno,10.44117165,139535,2870,142405,74672,2870,77542,0.9629878,0,64863,0,64863,1,1
93723,19,Fresno,41.07104328,9645,218,9863,5555,218,5773,0.962238005,0,4090,0,4090,1,1
93726,19,Fresno,6.381268351,155010,2416,157426,66182,2416,68598,0.964780314,0,88828,0,88828,1,1
93727,19,Fresno,21.9769943,161976,2878,164854,79052,2878,81930,0.964872452,0,82924,0,82924,1,1
93210,19,Fresno,775.3810984,41,2,43,24,2,26,0.923076923,0,17,0,17,1,1
93234,19,Fresno,134.9536379,6,1,7,4,1,5,0.8,0,2,0,2,1,1
93242,19,Fresno,40.71235491,97,11,108,62,11,73,0.849315068,0,35,0,35,1,1
93740,19,Fresno,0.87405855,0,0,0,0,0,0,0,0,0,0,0,0,0
93741,19,Fresno,0.114614609,0,0,0,0,0,0,0,0,0,0,0,0,0
94002,81,San Mateo,5.624388527,161606,6054,167660,112923,2558,115481,0.97784917,0,48683,3496,52179,0.932999866,0
94402,81,San Mateo,5.053297738,213090,5748,218838,152060,2407,154467,0.984417384,0,61030,3341,64371,0.948097746,0
94128,81,San Mateo,3.354270682,3042466,89627,3132093,1838771,28600,1867371,0.98468435,0,1203695,61027,1264722,0.951746708,0
94403,81,San Mateo,5.632715247,391386,12435,403821,283350,5950,289300,0.979433114,0,108036,6485,114521,0.943372831,0
94020,81,San Mateo,41.98208327,21,5,26,14,5,19,0.736842105,0,7,0,7,1,1
94028,81,San Mateo,17.32109535,21164,361,21525,13863,361,14224,0.97462036,0,7301,0,7301,1,1
94080,81,San Mateo,10.17731005,887610,24701,912311,595046,10235,605281,0.983090498,0,292564,14466,307030,0.952884083,0
94018,81,San Mateo,0.579021753,0,0,0,0,0,0,0,0,0,0,0,0,0
94044,81,San Mateo,15.08778712,192979,9062,202041,138578,3443,142021,0.975757106,0,54401,5619,60020,0.906381206,0
94005,81,San Mateo,4.580160782,91761,3007,94768,59327,778,60105,0.987055985,0,32434,2229,34663,0.935695122,0
94019,81,San Mateo,59.73639164,27037,2653,29690,19148,1718,20866,0.917665101,0,7889,935,8824,0.894038985,0
94037,81,San Mateo,5.502180795,3172,439,3611,2019,130,2149,0.939506747,0,1153,309,1462,0.788645691,0
94062,81,San Mateo,64.66423953,124631,2078,126709,84855,2000,86855,0.976973116,0,39776,78,39854,0.998042856,0
94025,81,San Mateo,8.365390411,537816,6265,544081,347517,6262,353779,0.982299684,0,190299,3,190302,0.999984236,0
94404,81,San Mateo,4.349974411,261984,7460,269444,189918,2970,192888,0.984602464,0,72066,4490,76556,0.941350123,0
94021,81,San Mateo,10.9532723,0,0,0,0,0,0,0,0,0,0,0,0,0
94038,81,San Mateo,5.945565343,3122,460,3582,2182,205,2387,0.91411814,0,940,255,1195,0.786610879,0
94061,81,San Mateo,3.861078617,183619,2475,186094,123942,2475,126417,0.980421937,0,59677,0,59677,1,1
94010,81,San Mateo,15.11763335,565450,16889,582339,388409,6808,395217,0.98277402,0,177041,10081,187122,0.946126057,0
94014,81,San Mateo,6.391368833,805175,19013,824188,562245,8032,570277,0.985915616,0,242930,10981,253911,0.956752563,0
94015,81,San Mateo,5.655586122,838349,19566,857915,615920,9354,625274,0.985040158,0,222429,10212,232641,0.95610404,0
94027,81,San Mateo,5.026817176,51074,704,51778,36916,704,37620,0.98128655,0,14158,0,14158,1,1
94030,81,San Mateo,3.374338441,261337,10179,271516,173069,4321,177390,0.975641242,0,88268,5858,94126,0.937764273,0
94060,81,San Mateo,73.45236873,11,0,11,4,0,4,1,1,7,0,7,1,1
94065,81,San Mateo,2.293633128,104728,2985,107713,73802,899,74701,0.987965355,0,30926,2086,33012,0.936810857,0
94401,81,San Mateo,3.110667967,337695,11019,348714,237650,5754,243404,0.97636029,0,100045,5265,105310,0.950004748,0
94066,81,San Mateo,6.060335166,496230,15173,511403,343900,6779,350679,0.980668931,0,152330,8394,160724,0.947773823,0
94063,81,San Mateo,6.502202712,450419,10420,460839,303142,8098,311240,0.973981493,0,147277,2322,149599,0.984478506,0
94070,81,San Mateo,6.121019916,222313,6882,229195,152109,2858,154967,0.981557364,0,70204,4024,74228,0.945788651,0
94074,81,San Mateo,23.12352071,4,0,4,0,0,0,0,0,4,0,4,1,1
94521,13,Contra Costa,9.682842776,103586,6091,109677,67147,1828,68975,0.973497644,0,36439,4263,40702,0.895263132,0
94519,13,Contra Costa,4.535964606,73136,3256,76392,48768,879,49647,0.982295003,0,24368,2377,26745,0.911123574,0
94563,13,Contra Costa,20.52294295,68632,5979,74611,43853,1379,45232,0.969512734,0,24779,4600,29379,0.843425576,0
94530,13,Contra Costa,4.330352988,261514,10566,272080,161457,2910,164367,0.982295716,0,100057,7656,107713,0.928922229,0
94569,13,Contra Costa,1.285778703,640,156,796,372,37,409,0.909535452,0,268,119,387,0.69250646,0
94517,13,Contra Costa,47.72525864,15599,1332,16931,10379,407,10786,0.9622659,0,5220,925,6145,0.849471115,0
94588,13,Contra Costa,32.74000764,216657,10166,226823,133870,2952,136822,0.978424522,0,82787,7214,90001,0.919845335,0
94598,13,Contra Costa,20.61403378,110665,5626,116291,70841,1601,72442,0.977899561,0,39824,4025,43849,0.908207713,0
94514,13,Contra Costa,30.01166302,836,51,887,496,51,547,0.906764168,0,340,0,340,1,1
94596,13,Contra Costa,6.062464916,316485,16137,332622,200689,5238,205927,0.974563802,0,115796,10899,126695,0.913974506,0
94506,13,Contra Costa,18.65576216,34186,2542,36728,22625,693,23318,0.97028047,0,11561,1849,13410,0.862117823,0
94556,13,Contra Costa,19.27896773,35670,3863,39533,18397,693,19090,0.963698271,0,17273,3170,20443,0.844934696,0
94597,13,Contra Costa,4.052831802,170412,7263,177675,108356,1960,110316,0.982232858,0,62056,5303,67359,0.921272584,0
94507,13,Contra Costa,11.19823757,36480,2288,38768,26157,733,26890,0.972740796,0,10323,1555,11878,0.869085705,0
94547,13,Contra Costa,5.670405183,56268,3687,59955,35314,826,36140,0.977144438,0,20954,2861,23815,0.879865631,0
94548,13,Contra Costa,2.310636379,252,6,258,156,6,162,0.962962963,0,96,0,96,1,1
94553,13,Contra Costa,61.63770209,134003,9190,143193,85371,2470,87841,0.971881012,0,48632,6720,55352,0.878595173,0
94565,13,Contra Costa,45.29287014,348180,21750,369930,209553,4537,214090,0.978807978,0,138627,17213,155840,0.889546971,0
94572,13,Contra Costa,9.191147341,27140,2106,29246,15998,445,16443,0.972936812,0,11142,1661,12803,0.870264782,0
94801,13,Contra Costa,11.52855502,199221,10393,209614,116767,2911,119678,0.975676398,0,82454,7482,89936,0.916807508,0
94805,13,Contra Costa,1.865262236,84257,3302,87559,51781,965,52746,0.981704774,0,32476,2337,34813,0.932869905,0
94575,13,Contra Costa,0.160967176,12196,1602,13798,2138,76,2214,0.96567299,0,10058,1526,11584,0.868266575,0
94582,13,Contra Costa,13.41141704,66121,3853,69974,41907,1092,42999,0.974604061,0,24214,2761,26975,0.897645968,0
94583,13,Contra Costa,21.23613239,133825,6710,140535,90046,2061,92107,0.977623851,0,43779,4649,48428,0.904001817,0
94595,13,Contra Costa,5.218420939,45815,2681,48496,28083,632,28715,0.977990597,0,17732,2049,19781,0.896415752,0
94708,13,Contra Costa,3.330149988,62958,3549,66507,36627,672,37299,0.981983431,0,26331,2877,29208,0.901499589,0
94803,13,Contra Costa,12.81909979,91067,4927,95994,55729,1353,57082,0.976297257,0,35338,3574,38912,0.908151727,0
94804,13,Contra Costa,6.480499801,273191,13021,286212,165403,3488,168891,0.979347627,0,107788,9533,117321,0.9187443,0
94806,13,Contra Costa,7.851840713,348708,16481,365189,215680,5247,220927,0.976250074,0,133028,11234,144262,0.922127795,0
94505,13,Contra Costa,16.67183895,6947,276,7223,3278,276,3554,0.922341024,0,3669,0,3669,1,1
94509,13,Contra Costa,17.44364324,235502,12130,247632,131659,2861,134520,0.978731787,0,103843,9269,113112,0.918054671,0
94513,13,Contra Costa,78.85745554,109787,5388,115175,71673,1893,73566,0.974268004,0,38114,3495,41609,0.916003749,0
94549,13,Contra Costa,19.84573532,119783,7640,127423,76197,1917,78114,0.975458945,0,43586,5723,49309,0.883935995,0
94561,13,Contra Costa,17.33935498,60054,2975,63029,35796,927,36723,0.974756964,0,24258,2048,26306,0.922147039,0
94564,13,Contra Costa,6.829412018,100687,5189,105876,64920,1503,66423,0.977372296,0,35767,3686,39453,0.906572377,0
94511,13,Contra Costa,5.251869135,971,51,1022,428,51,479,0.893528184,0,543,0,543,1,1
94516,13,Contra Costa,3.612587052,26,0,26,23,0,23,1,1,3,0,3,1,1
94518,13,Contra Costa,5.54076765,119658,4835,124493,82684,1547,84231,0.98163384,0,36974,3288,40262,0.918334906,0
94520,13,Contra Costa,9.87193802,318078,15546,333624,198658,4655,203313,0.977104268,0,119420,10891,130311,0.916423019,0
94523,13,Contra Costa,7.205671986,196440,8349,204789,131399,2678,134077,0.980026403,0,65041,5671,70712,0.919801448,0
94525,13,Contra Costa,2.452400669,8025,892,8917,4801,156,4957,0.968529352,0,3224,736,3960,0.814141414,0
94526,13,Contra Costa,13.1703989,84797,5922,90719,57612,2078,59690,0.965186798,0,27185,3844,31029,0.876115892,0
94528,13,Contra Costa,1.15395698,2194,178,2372,1601,64,1665,0.961561562,0,593,114,707,0.838755304,0
94531,13,Contra Costa,14.02781366,198792,8254,207046,116943,1951,118894,0.983590425,0,81849,6303,88152,0.928498503,0
94535,95,Solano,9.602420385,1931,36,1967,1279,36,1315,0.972623574,0,652,0,652,1,1
94590,95,Solano,6.562572787,158817,1781,160598,88572,1781,90353,0.980288424,0,70245,0,70245,1,1
94592,95,Solano,8.010288174,4238,50,4288,2661,50,2711,0.981556621,0,1577,0,1577,1,1
95687,95,Solano,44.55716349,103350,1317,104667,58806,1317,60123,0.978094905,0,44544,0,44544,1,1
94534,95,Solano,77.54656116,56919,819,57738,31429,819,32248,0.974603076,0,25490,0,25490,1,1
94510,95,Solano,29.17437084,36533,723,37256,20293,723,21016,0.96559764,0,16240,0,16240,1,1
94571,95,Solano,109.0982706,757,17,774,166,17,183,0.907103825,0,591,0,591,1,1
95625,95,Solano,0.921044328,114,7,121,77,7,84,0.916666667,0,37,0,37,1,1
95688,95,Solano,91.96802607,65726,1119,66845,38541,1119,39660,0.971785174,0,27185,0,27185,1,1
94585,95,Solano,106.1910941,39275,482,39757,21870,482,22352,0.978435934,0,17405,0,17405,1,1
94589,95,Solano,5.664860729,81091,1121,82212,45399,1121,46520,0.975902837,0,35692,0,35692,1,1
94591,95,Solano,21.09724072,117372,1500,118872,66958,1500,68458,0.978088755,0,50414,0,50414,1,1
94512,95,Solano,22.20742122,1,0,1,1,0,1,1,1,0,0,0,0,0
94533,95,Solano,22.52597986,158471,1794,160265,85950,1794,87744,0.979554158,0,72521,0,72521,1,1
95620,95,Solano,241.2680447,11914,295,12209,5410,295,5705,0.948290973,0,6504,0,6504,1,1
94545,1,Alameda,14.47992339,257116,9841,266957,183889,3487,187376,0.981390359,0,73227,6354,79581,0.920156821,0
94612,1,Alameda,0.958241595,901715,41608,943323,483770,12429,496199,0.974951582,0,417945,29179,447124,0.934740698,0
94710,1,Alameda,2.159973162,276581,9571,286152,166866,2437,169303,0.985605689,0,109715,7134,116849,0.938946846,0
94606,1,Alameda,2.326085561,500575,20818,521393,271179,4784,275963,0.982664343,0,229396,16034,245430,0.934669763,0
94541,1,Alameda,7.454378997,452590,17302,469892,308234,6391,314625,0.979686929,0,144356,10911,155267,0.929727502,0
94555,1,Alameda,13.85545719,95245,3795,99040,65718,1238,66956,0.981510246,0,29527,2557,32084,0.920302955,0
94587,1,Alameda,19.63124562,324997,11512,336509,231991,4232,236223,0.982084725,0,93006,7280,100286,0.927407614,0
94539,1,Alameda,25.07497103,202542,5535,208077,135435,1884,137319,0.986280121,0,67107,3651,70758,0.948401594,0
94586,1,Alameda,55.72650889,1598,262,1860,982,56,1038,0.946050096,0,616,206,822,0.749391727,0
94705,1,Alameda,3.380704526,236842,8974,245816,140103,2106,142209,0.985190811,0,96739,6868,103607,0.933711043,0
94552,1,Alameda,51.80041344,22920,1509,24429,15079,376,15455,0.975671304,0,7841,1133,8974,0.873746378,0
94707,1,Alameda,1.762082485,75128,3012,78140,43866,623,44489,0.985996538,0,31262,2389,33651,0.929006567,0
94610,1,Alameda,2.091367873,518631,20757,539388,269969,4478,274447,0.983683553,0,248662,16279,264941,0.938556131,0
94703,1,Alameda,1.287683741,287985,9942,297927,164596,2433,167029,0.985433667,0,123389,7509,130898,0.942634723,0
94536,1,Alameda,14.07708209,300953,9500,310453,215976,3979,219955,0.981909936,0,84977,5521,90498,0.938993127,0
94619,1,Alameda,8.345747366,188308,9744,198052,107235,2110,109345,0.980703279,0,81073,7634,88707,0.913941403,0
94501,1,Alameda,7.973327975,570407,25185,595592,342319,5977,348296,0.982839309,0,228088,19208,247296,0.922327899,0
94538,1,Alameda,16.53780832,515140,15696,530836,365209,7037,372246,0.981095834,0,149931,8659,158590,0.945400088,0
95391,1,Alameda,26.85459422,12259,219,12478,5407,219,5626,0.961073587,0,6852,0,6852,1,1
94542,1,Alameda,8.653214012,83653,3452,87105,58650,1133,59783,0.981048124,0,25003,2319,27322,0.915123344,0
94544,1,Alameda,10.95191514,437660,16445,454105,298680,5735,304415,0.981160587,0,138980,10710,149690,0.928452134,0
94551,1,Alameda,82.73662854,150830,8136,158966,98351,2324,100675,0.976915818,0,52479,5812,58291,0.900293356,0
94577,1,Alameda,8.114609635,417864,17553,435417,265348,5632,270980,0.979216178,0,152516,11921,164437,0.927504151,0
94607,1,Alameda,5.891362894,1017613,45781,1063394,552065,11278,563343,0.979980225,0,465548,34503,500051,0.931001038,0
94611,1,Alameda,7.299919605,437683,20085,457768,242978,4421,247399,0.982130081,0,194705,15664,210369,0.92554036,0
94704,1,Alameda,0.851064122,868965,30855,899820,560364,9619,569983,0.983124058,0,308601,21236,329837,0.935616683,0
94709,1,Alameda,0.675599896,190655,6030,196685,118580,1422,120002,0.988150197,0,72075,4608,76683,0.939908454,0
94566,1,Alameda,20.3212055,104385,6075,110460,65712,1841,67553,0.972747324,0,38673,4234,42907,0.901321463,0
94568,1,Alameda,16.49455308,279465,13421,292886,173788,3932,177720,0.977875309,0,105677,9489,115166,0.917605891,0
94578,1,Alameda,4.558650924,324559,13257,337816,205879,4128,210007,0.980343512,0,118680,9129,127809,0.928573105,0
94579,1,Alameda,3.127648052,88123,3670,91793,59113,1145,60258,0.980998374,0,29010,2525,31535,0.919930236,0
94580,1,Alameda,3.322361497,115892,4557,120449,79920,1576,81496,0.980661628,0,35972,2981,38953,0.923471876,0
94601,1,Alameda,3.199251439,551731,23559,575290,325455,6112,331567,0.98156632,0,226276,17447,243723,0.928414635,0
94602,1,Alameda,3.637522425,259402,13593,272995,138336,2603,140939,0.981531017,0,121066,10990,132056,0.916777731,0
94603,1,Alameda,2.698120007,256563,11830,268393,151615,3295,154910,0.978729585,0,104948,8535,113483,0.924790497,0
94605,1,Alameda,8.829726125,344979,17983,362962,195785,4287,200072,0.978572714,0,149194,13696,162890,0.915918718,0
94608,1,Alameda,2.751704689,788736,33283,822019,457595,8391,465986,0.981993021,0,331141,24892,356033,0.930085133,0
94609,1,Alameda,1.665329437,553382,22226,575608,286151,5339,291490,0.981683763,0,267231,16887,284118,0.940563428,0
94613,1,Alameda,0.245064119,12256,547,12803,7385,133,7518,0.982309125,0,4871,414,5285,0.92166509,0
94618,1,Alameda,2.423072203,260167,10597,270764,147669,2328,149997,0.98447969,0,112498,8269,120767,0.931529309,0
94621,1,Alameda,8.513692215,1144114,49596,1193710,639156,12614,651770,0.980646547,0,504958,36982,541940,0.931759973,0
94702,1,Alameda,1.281977509,227479,7672,235151,129448,1842,131290,0.98596999,0,98031,5830,103861,0.943867284,0
94706,1,Alameda,1.464340642,144258,5193,149451,86552,1364,87916,0.98448519,0,57706,3829,61535,0.93777525,0
94720,1,Alameda,0.70406233,140670,5440,146110,102641,1873,104514,0.982078956,0,38029,3567,41596,0.914246562,0
94550,1,Alameda,271.9771055,114255,7410,121665,73102,2620,75722,0.965399752,0,41153,4790,45943,0.895740374,0
94560,1,Alameda,20.07639235,262717,9044,271761,184932,3210,188142,0.982938419,0,77785,5834,83619,0.930231168,0
94546,1,Alameda,15.9575298,182936,8431,191367,120551,2755,123306,0.977657211,0,62385,5676,68061,0.916604223,0
94502,1,Alameda,2.522152301,61045,3079,64124,35909,705,36614,0.98074507,0,25136,2374,27510,0.913704108,0
94901,41,Marin,13.10228744,198706,10568,209274,117614,3261,120875,0.973021717,0,81092,7307,88399,0.917340694,0
94938,41,Marin,9.482518853,104,27,131,44,6,50,0.88,0,60,21,81,0.740740741,0
94930,41,Marin,14.23916588,14808,1576,16384,8873,478,9351,0.948882472,0,5935,1098,7033,0.843878857,0
94929,41,Marin,0.9451434,1,1,2,0,1,1,0,0,1,0,1,1,1
94963,41,Marin,1.596656579,124,21,145,74,10,84,0.880952381,0,50,11,61,0.819672131,0
94973,41,Marin,3.950533912,400,85,485,210,27,237,0.886075949,0,190,58,248,0.766129032,0
94933,41,Marin,3.21096854,154,45,199,95,21,116,0.818965517,0,59,24,83,0.710843373,0
94937,41,Marin,56.21576029,2,1,3,2,1,3,0.666666667,0,0,0,0,0,0
94939,41,Marin,2.360013299,56529,3084,59613,37183,998,38181,0.973861345,0,19346,2086,21432,0.902668906,0
94957,41,Marin,1.420405859,4627,236,4863,3462,93,3555,0.973839662,0,1165,143,1308,0.890672783,0
94949,41,Marin,13.42255266,38879,2306,41185,22994,645,23639,0.972714582,0,15885,1661,17546,0.905334549,0
94940,41,Marin,26.20446832,82,1,83,1,1,2,0.5,0,81,0,81,1,1
94925,41,Marin,3.21137781,54438,2683,57121,35218,840,36058,0.976704199,0,19220,1843,21063,0.912500593,0
94945,41,Marin,23.30407765,39269,789,40058,22916,789,23705,0.966715883,0,16353,0,16353,1,1
94903,41,Marin,19.88484264,88257,4589,92846,54390,1390,55780,0.975080674,0,33867,3199,37066,0.913694491,0
94904,41,Marin,4.946750001,54703,2682,57385,37133,972,38105,0.974491537,0,17570,1710,19280,0.911307054,0
94920,41,Marin,6.510246032,46818,3114,49932,31119,1075,32194,0.966608685,0,15699,2039,17738,0.885049047,0
94924,41,Marin,27.45273855,9,6,15,6,4,10,0.6,0,3,2,5,0.6,0
94941,41,Marin,37.70983199,136814,8247,145061,89552,2754,92306,0.970164453,0,47262,5493,52755,0.895877168,0
94946,41,Marin,37.22213775,157,25,182,96,11,107,0.897196262,0,61,14,75,0.813333333,0
94947,41,Marin,21.93558155,29379,590,29969,16567,579,17146,0.966231191,0,12812,11,12823,0.999142166,0
94950,41,Marin,4.845327024,142,5,147,6,3,9,0.666666667,0,136,2,138,0.985507246,0
94956,41,Marin,34.70878631,60,6,66,14,6,20,0.7,0,46,0,46,1,1
94960,41,Marin,5.879279381,34573,2273,36846,22571,823,23394,0.964820039,0,12002,1450,13452,0.892209337,0
94964,41,Marin,0.456460735,445,45,490,252,18,270,0.933333333,0,193,27,220,0.877272727,0
94965,41,Marin,14.57797954,141890,11034,152924,94409,3155,97564,0.967662252,0,47481,7879,55360,0.857677023,0
94970,41,Marin,7.23020002,232,84,316,140,42,182,0.769230769,0,92,42,134,0.686567164,0
94971,41,Marin,22.1712452,8,3,11,3,3,6,0.5,0,5,0,5,1,1
95019,87,Santa Cruz,1.094127064,6246,147,6393,4244,147,4391,0.966522432,0,2002,0,2002,1,1
95073,87,Santa Cruz,22.89994869,29263,569,29832,21856,569,22425,0.974626533,0,7407,0,7407,1,1
95017,87,Santa Cruz,62.44380015,164,9,173,90,9,99,0.909090909,0,74,0,74,1,1
95076,87,Santa Cruz,135.0984782,47217,1278,48495,28633,1278,29911,0.957273244,0,18584,0,18584,1,1
95006,87,Santa Cruz,55.16951669,793,110,903,447,110,557,0.802513465,0,346,0,346,1,1
95062,87,Santa Cruz,5.052717424,146593,2111,148704,106280,2111,108391,0.980524213,0,40313,0,40313,1,1
95003,87,Santa Cruz,32.42524015,44266,940,45206,32648,940,33588,0.972013814,0,11618,0,11618,1,1
95041,87,Santa Cruz,0.193513433,108,2,110,39,2,41,0.951219512,0,69,0,69,1,1
95007,87,Santa Cruz,1.58589277,107,7,114,53,7,60,0.883333333,0,54,0,54,1,1
95064,87,Santa Cruz,1.70186801,60905,362,61267,44370,362,44732,0.991907359,0,16535,0,16535,1,1
95060,87,Santa Cruz,54.54791384,346948,4615,351563,251056,4615,255671,0.981949458,0,95892,0,95892,1,1
95065,87,Santa Cruz,10.9433,23298,311,23609,15837,311,16148,0.980740649,0,7461,0,7461,1,1
95066,87,Santa Cruz,18.7247551,27597,449,28046,17974,449,18423,0.975628291,0,9623,0,9623,1,1
95005,87,Santa Cruz,11.81107934,2691,243,2934,1789,243,2032,0.880413386,0,902,0,902,1,1
95010,87,Santa Cruz,1.382802797,54211,891,55102,39273,891,40164,0.977815955,0,14938,0,14938,1,1
95018,87,Santa Cruz,17.44488495,6229,280,6509,3911,280,4191,0.933190169,0,2318,0,2318,1,1
95118,85,Santa Clara,4.065940807,126726,1192,127918,74531,1192,75723,0.984258416,0,52195,0,52195,1,1
95128,85,Santa Clara,3.930786619,371443,4653,376096,229827,4653,234480,0.98015609,0,141616,0,141616,1,1
94087,85,Santa Clara,6.59101553,311771,2892,314663,198911,2892,201803,0.985669192,0,112860,0,112860,1,1
95122,85,Santa Clara,4.782024488,290869,3212,294081,176107,3212,179319,0.982087788,0,114762,0,114762,1,1
95138,85,Santa Clara,26.03570454,52844,485,53329,31832,485,32317,0.984992419,0,21012,0,21012,1,1
95035,85,Santa Clara,22.43261565,534138,5292,539430,365947,5292,371239,0.985745032,0,168191,0,168191,1,1
94041,85,Santa Clara,1.591033746,273049,2768,275817,169556,2768,172324,0.983937235,0,103493,0,103493,1,1
95013,85,Santa Clara,1.773793408,271,2,273,186,2,188,0.989361702,0,85,0,85,1,1
95123,85,Santa Clara,7.822065911,259861,2829,262690,148757,2829,151586,0.981337327,0,111104,0,111104,1,1
95140,85,Santa Clara,76.84716528,17,2,19,14,2,16,0.875,0,3,0,3,1,1
95037,85,Santa Clara,120.0787952,64471,1326,65797,40649,1326,41975,0.968409768,0,23822,0,23822,1,1
95139,85,Santa Clara,1.20516635,10768,131,10899,6262,131,6393,0.979508838,0,4506,0,4506,1,1
95148,85,Santa Clara,7.882614366,108532,1062,109594,63720,1062,64782,0.983606557,0,44812,0,44812,1,1
94301,85,Santa Clara,2.370240038,413963,4762,418725,272279,4762,277041,0.982811208,0,141684,0,141684,1,1
94303,85,Santa Clara,8.439076057,322878,4835,327713,197956,4835,202791,0.976157719,0,124922,0,124922,1,1
95070,85,Santa Clara,28.32159551,78360,843,79203,49946,843,50789,0.983401918,0,28414,0,28414,1,1
95120,85,Santa Clara,39.30133794,50150,457,50607,32270,457,32727,0.986035995,0,17880,0,17880,1,1
95136,85,Santa Clara,5.203339327,179516,1622,181138,106629,1622,108251,0.985016305,0,72887,0,72887,1,1
94306,85,Santa Clara,4.085486168,315703,2910,318613,202104,2910,205014,0.985805847,0,113599,0,113599,1,1
94024,85,Santa Clara,8.272950917,69897,673,70570,44363,673,45036,0.985056399,0,25534,0,25534,1,1
94043,85,Santa Clara,8.458127977,482405,4522,486927,280198,4522,284720,0.98411773,0,202207,0,202207,1,1
94022,85,Santa Clara,17.71788177,124493,1256,125749,81566,1256,82822,0.984834947,0,42927,0,42927,1,1
94040,85,Santa Clara,3.660009127,348878,3079,351957,210987,3079,214066,0.985616586,0,137891,0,137891,1,1
94304,85,Santa Clara,4.806659859,203094,2579,205673,129164,2579,131743,0.980424007,0,73930,0,73930,1,1
94305,85,Santa Clara,4.779599754,251001,2587,253588,162185,2587,164772,0.984299517,0,88816,0,88816,1,1
94085,85,Santa Clara,3.512693046,333036,2739,335775,206232,2739,208971,0.986892918,0,126804,0,126804,1,1
94086,85,Santa Clara,4.366715112,516802,5001,521803,322460,5001,327461,0.984727952,0,194342,0,194342,1,1
94089,85,Santa Clara,6.085013781,330064,2967,333031,212012,2967,214979,0.986198652,0,118052,0,118052,1,1
95046,85,Santa Clara,18.81005591,5003,75,5078,3198,75,3273,0.977085243,0,1805,0,1805,1,1
95110,85,Santa Clara,4.5543254,1472213,14352,1486565,902296,14352,916648,0.984342954,0,569917,0,569917,1,1
95111,85,Santa Clara,5.805395663,189424,2182,191606,113796,2182,115978,0.981186087,0,75628,0,75628,1,1
95121,85,Santa Clara,4.445246751,131455,1350,132805,79480,1350,80830,0.98329828,0,51975,0,51975,1,1
95129,85,Santa Clara,4.563144789,201425,1930,203355,129050,1930,130980,0.985264926,0,72375,0,72375,1,1
95135,85,Santa Clara,129.4425095,36441,344,36785,22667,344,23011,0.985050628,0,13774,0,13774,1,1
95131,85,Santa Clara,5.775479933,247465,2109,249574,163564,2109,165673,0.987270104,0,83901,0,83901,1,1
95050,85,Santa Clara,5.455364903,452015,6050,458065,287977,6050,294027,0.979423658,0,164038,0,164038,1,1
95051,85,Santa Clara,6.591124797,505179,4620,509799,310859,4620,315479,0.985355602,0,194320,0,194320,1,1
95053,85,Santa Clara,0.146697542,24899,192,25091,18900,192,19092,0.989943432,0,5999,0,5999,1,1
95054,85,Santa Clara,6.423211609,581614,9334,590948,393164,9334,402498,0.976809823,0,188450,0,188450,1,1
95112,85,Santa Clara,7.269849048,733565,8375,741940,432547,8375,440922,0.981005711,0,301018,0,301018,1,1
95113,85,Santa Clara,0.348279392,415706,9013,424719,257243,9013,266256,0.96614912,0,158463,0,158463,1,1
95116,85,Santa Clara,3.563692376,244593,2878,247471,150599,2878,153477,0.981248005,0,93994,0,93994,1,1
95117,85,Santa Clara,2.320290911,174230,1525,175755,103423,1525,104948,0.985468994,0,70807,0,70807,1,1
95119,85,Santa Clara,4.251969999,43386,421,43807,25060,421,25481,0.983477885,0,18326,0,18326,1,1
95124,85,Santa Clara,6.588487707,155892,1358,157250,93359,1358,94717,0.985662553,0,62533,0,62533,1,1
95125,85,Santa Clara,7.284698224,300778,3034,303812,181803,3034,184837,0.983585538,0,118975,0,118975,1,1
95126,85,Santa Clara,3.317548709,352504,3354,355858,205616,3354,208970,0.983949849,0,146888,0,146888,1,1
95127,85,Santa Clara,19.03115919,224730,2324,227054,141029,2324,143353,0.983788271,0,83701,0,83701,1,1
95130,85,Santa Clara,1.439009126,44894,312,45206,24634,312,24946,0.987492985,0,20260,0,20260,1,1
95132,85,Santa Clara,27.35358123,106667,872,107539,66661,872,67533,0.987087794,0,40006,0,40006,1,1
95133,85,Santa Clara,3.261380991,129566,1375,130941,82621,1375,83996,0.983630173,0,46945,0,46945,1,1
95134,85,Santa Clara,10.80811956,342170,3487,345657,234831,3487,238318,0.985368289,0,107339,0,107339,1,1
95008,85,Santa Clara,6.463369136,333897,3538,337435,199353,3538,202891,0.982562065,0,134544,0,134544,1,1
95033,85,Santa Clara,89.44548535,4422,224,4646,2767,224,2991,0.925108659,0,1655,0,1655,1,1
95002,85,Santa Clara,9.578652591,40289,416,40705,27736,416,28152,0.985223075,0,12553,0,12553,1,1
95014,85,Santa Clara,24.86055238,407907,3254,411161,248261,3254,251515,0.987062402,0,159646,0,159646,1,1
95020,85,Santa Clara,151.7852934,60389,1304,61693,41026,1304,42330,0.969194425,0,19363,0,19363,1,1
95030,85,Santa Clara,10.54439464,82171,1212,83383,55403,1212,56615,0.978592246,0,26768,0,26768,1,1
95032,85,Santa Clara,18.66675416,121744,1102,122846,79705,1102,80807,0.986362568,0,42039,0,42039,1,1
95318,43,Mariposa,57.11528318,0,0,0,0,0,0,0,0,0,0,0,0,0
95306,43,Mariposa,166.4938456,0,0,0,0,0,0,0,0,0,0,0,0,0
95311,43,Mariposa,242.0948623,0,0,0,0,0,0,0,0,0,0,0,0,0
93623,43,Mariposa,18.73406716,0,0,0,0,0,0,0,0,0,0,0,0,0
95389,43,Mariposa,300.7194657,2,0,2,1,0,1,1,1,1,0,1,1,1
95325,43,Mariposa,29.7590718,0,0,0,0,0,0,0,0,0,0,0,0,0
95338,43,Mariposa,340.0884827,8,0,8,2,0,2,1,1,6,0,6,1,1
95345,43,Mariposa,38.02338827,2,0,2,1,0,1,1,1,1,0,1,1,1
95336,77,San Joaquin,38.33606115,45999,1284,47283,22423,1284,23707,0.945838782,0,23576,0,23576,1,1
95203,77,San Joaquin,6.165093697,44895,619,45514,19115,619,19734,0.968632816,0,25780,0,25780,1,1
95330,77,San Joaquin,21.5254479,32464,711,33175,16409,711,17120,0.958469626,0,16055,0,16055,1,1
95212,77,San Joaquin,21.18243265,39410,648,40058,18762,648,19410,0.966615147,0,20648,0,20648,1,1
95231,77,San Joaquin,10.76419829,11969,291,12260,6010,291,6301,0.953816854,0,5959,0,5959,1,1
95376,77,San Joaquin,7.616644255,69810,1533,71343,35068,1533,36601,0.958115898,0,34742,0,34742,1,1
95209,77,San Joaquin,8.238016606,50853,709,51562,22888,709,23597,0.969953808,0,27965,0,27965,1,1
95220,77,San Joaquin,58.05896401,2374,87,2461,1205,87,1292,0.932662539,0,1169,0,1169,1,1
95377,77,San Joaquin,109.9618329,33834,635,34469,16190,635,16825,0.962258544,0,17644,0,17644,1,1
95227,77,San Joaquin,38.06015619,116,16,132,56,16,72,0.777777778,0,60,0,60,1,1
95366,77,San Joaquin,34.31957873,11775,417,12192,4527,417,4944,0.91565534,0,7248,0,7248,1,1
95202,77,San Joaquin,1.060185813,49449,643,50092,20593,643,21236,0.969721228,0,28856,0,28856,1,1
95204,77,San Joaquin,5.301971158,77951,1106,79057,32931,1106,34037,0.967505949,0,45020,0,45020,1,1
95205,77,San Joaquin,8.991318403,55694,933,56627,24699,933,25632,0.963600187,0,30995,0,30995,1,1
95206,77,San Joaquin,133.2407045,99437,1397,100834,39119,1397,40516,0.965519795,0,60318,0,60318,1,1
95207,77,San Joaquin,7.245905962,176267,2117,178384,77101,2117,79218,0.973276276,0,99166,0,99166,1,1
95210,77,San Joaquin,7.604208615,78072,1168,79240,32543,1168,33711,0.965352556,0,45529,0,45529,1,1
95211,77,San Joaquin,0.098663492,4726,45,4771,2944,45,2989,0.984944798,0,1782,0,1782,1,1
95215,77,San Joaquin,92.8192458,22073,471,22544,10943,471,11414,0.958734887,0,11130,0,11130,1,1
95219,77,San Joaquin,116.8611019,49132,841,49973,23759,841,24600,0.965813008,0,25373,0,25373,1,1
95337,77,San Joaquin,45.42552816,39756,961,40717,18436,961,19397,0.950456256,0,21320,0,21320,1,1
95240,77,San Joaquin,68.18706587,55167,1595,56762,29828,1595,31423,0.949241002,0,25339,0,25339,1,1
95236,77,San Joaquin,127.5215263,207,21,228,101,21,122,0.827868852,0,106,0,106,1,1
95237,77,San Joaquin,7.414840009,564,33,597,260,33,293,0.887372014,0,304,0,304,1,1
95242,77,San Joaquin,90.86999357,24539,598,25137,13978,598,14576,0.958973655,0,10561,0,10561,1,1
95686,77,San Joaquin,32.3938719,288,19,307,108,19,127,0.850393701,0,180,0,180,1,1
95258,77,San Joaquin,3.218998346,2222,99,2321,1316,99,1415,0.930035336,0,906,0,906,1,1
95304,77,San Joaquin,153.4717705,37463,838,38301,17949,838,18787,0.955394688,0,19514,0,19514,1,1
95320,77,San Joaquin,88.72914723,2721,151,2872,769,151,920,0.835869565,0,1952,0,1952,1,1
95253,77,San Joaquin,1.683329223,0,0,0,0,0,0,0,0,0,0,0,0,0
95404,97,Sonoma,75.38612158,115429,1231,116660,60771,1231,62002,0.980145802,0,54658,0,54658,1,1
95405,97,Sonoma,5.016276149,55315,629,55944,28764,629,29393,0.978600347,0,26551,0,26551,1,1
95465,97,Sonoma,48.07880372,328,10,338,88,10,98,0.897959184,0,240,0,240,1,1
95401,97,Sonoma,20.90438559,154351,1705,156056,83308,1705,85013,0.979944244,0,71043,0,71043,1,1
95407,97,Sonoma,21.6111132,138184,1988,140172,73390,1988,75378,0.973626257,0,64794,0,64794,1,1
95480,97,Sonoma,5.390863514,0,0,0,0,0,0,0,0,0,0,0,0,0
95409,97,Sonoma,34.97853754,37380,477,37857,20820,477,21297,0.977602479,0,16560,0,16560,1,1
95452,97,Sonoma,16.55532123,3000,95,3095,2063,95,2158,0.955977757,0,937,0,937,1,1
95497,97,Sonoma,15.23640553,0,0,0,0,0,0,0,0,0,0,0,0,0
95446,97,Sonoma,31.04590959,861,60,921,405,60,465,0.870967742,0,456,0,456,1,1
95492,97,Sonoma,19.78762125,40229,493,40722,21202,493,21695,0.97727587,0,19027,0,19027,1,1
95472,97,Sonoma,70.26434365,29775,571,30346,15070,571,15641,0.963493383,0,14705,0,14705,1,1
95436,97,Sonoma,21.253387,3617,152,3769,2087,152,2239,0.93211255,0,1530,0,1530,1,1
95403,97,Sonoma,21.54047391,124979,1325,126304,66614,1325,67939,0.980497211,0,58365,0,58365,1,1
95412,97,Sonoma,90.32097249,0,0,0,0,0,0,0,0,0,0,0,0,0
95421,97,Sonoma,143.3876274,5,2,7,1,2,3,0.333333333,0,4,0,4,1,1
95425,97,Sonoma,191.8072502,288,16,304,170,16,186,0.913978495,0,118,0,118,1,1
95430,97,Sonoma,0.23758065,2,0,2,2,0,2,1,1,0,0,0,0,0
95431,97,Sonoma,0.12042509,10,0,10,5,0,5,1,1,5,0,5,1,1
95439,97,Sonoma,2.666841329,1487,14,1501,817,14,831,0.983152828,0,670,0,670,1,1
95471,97,Sonoma,3.548874087,39,1,40,12,1,13,0.923076923,0,27,0,27,1,1
95441,97,Sonoma,157.1670252,2928,92,3020,1774,92,1866,0.950696677,0,1154,0,1154,1,1
95442,97,Sonoma,24.97798632,7366,225,7591,5331,225,5556,0.95950324,0,2035,0,2035,1,1
95444,97,Sonoma,0.313512264,604,27,631,303,27,330,0.918181818,0,301,0,301,1,1
95448,97,Sonoma,184.8387847,41918,1095,43013,25295,1095,26390,0.95850701,0,16623,0,16623,1,1
94923,97,Sonoma,19.29969187,51,2,53,23,2,25,0.92,0,28,0,28,1,1
94928,97,Sonoma,7.745950511,129108,1578,130686,70692,1578,72270,0.978165214,0,58416,0,58416,1,1
94922,97,Sonoma,4.358803453,46,4,50,21,4,25,0.84,0,25,0,25,1,1
94972,97,Sonoma,4.561199597,0,0,0,0,0,0,0,0,0,0,0,0,0
95450,97,Sonoma,37.37846589,3,0,3,1,0,1,1,1,2,0,2,1,1
95462,97,Sonoma,3.615796349,73,5,78,25,5,30,0.833333333,0,48,0,48,1,1
95476,97,Sonoma,107.8369597,78326,2207,80533,57917,2207,60124,0.963292529,0,20409,0,20409,1,1
95486,97,Sonoma,0.019368911,2,0,2,1,0,1,1,1,1,0,1,1,1
94931,97,Sonoma,7.735226084,28992,502,29494,15558,502,16060,0.968742217,0,13434,0,13434,1,1
94951,97,Sonoma,12.85475998,6406,142,6548,3459,142,3601,0.960566509,0,2947,0,2947,1,1
94952,97,Sonoma,198.5175707,88694,2010,90704,53727,2010,55737,0.963937779,0,34967,0,34967,1,1
94954,97,Sonoma,62.17735358,69350,968,70318,40538,968,41506,0.976678071,0,28812,0,28812,1,1
95419,97,Sonoma,0.064785562,0,0,0,0,0,0,0,0,0,0,0,0,0
95437,45,Mendocino,177.400468,134,11,145,133,11,144,0.923611111,0,1,0,1,1,1
95587,45,Mendocino,19.14172665,0,0,0,0,0,0,0,0,0,0,0,0,0
95429,45,Mendocino,25.41457814,0,0,0,0,0,0,0,0,0,0,0,0,0
95463,45,Mendocino,7.230297704,0,0,0,0,0,0,0,0,0,0,0,0,0
95417,45,Mendocino,23.99915843,0,0,0,0,0,0,0,0,0,0,0,0,0
95469,45,Mendocino,184.5845556,2,2,4,1,2,3,0.333333333,0,1,0,1,1,1
95454,45,Mendocino,306.5563868,0,0,0,0,0,0,0,0,0,0,0,0,0
95466,45,Mendocino,102.801293,1,0,1,0,0,0,0,0,1,0,1,1,1
95415,45,Mendocino,55.29201709,2,0,2,0,0,0,0,0,2,0,2,1,1
95449,45,Mendocino,138.5239473,33,1,34,15,1,16,0.9375,0,18,0,18,1,1
95585,45,Mendocino,58.63661896,0,0,0,0,0,0,0,0,0,0,0,0,0
95410,45,Mendocino,30.0237392,0,0,0,0,0,0,0,0,0,0,0,0,0
95420,45,Mendocino,7.280271927,1,0,1,1,0,1,1,1,0,0,0,0,0
95427,45,Mendocino,56.37237067,0,0,0,0,0,0,0,0,0,0,0,0,0
95428,45,Mendocino,274.6699205,0,0,0,0,0,0,0,0,0,0,0,0,0
95432,45,Mendocino,72.0181527,0,0,0,0,0,0,0,0,0,0,0,0,0
95456,45,Mendocino,11.33097205,4,12,16,3,12,15,0.2,0,1,0,1,1,1
95488,45,Mendocino,61.34137957,0,0,0,0,0,0,0,0,0,0,0,0,0
95445,45,Mendocino,89.19433392,0,0,0,0,0,0,0,0,0,0,0,0,0
95459,45,Mendocino,59.33713106,0,0,0,0,0,0,0,0,0,0,0,0,0
95460,45,Mendocino,34.58011365,17,8,25,17,8,25,0.68,0,0,0,0,0,0
95468,45,Mendocino,60.69669194,0,0,0,0,0,0,0,0,0,0,0,0,0
95470,45,Mendocino,69.56294737,84,5,89,74,5,79,0.936708861,0,10,0,10,1,1
95482,45,Mendocino,294.1575199,2113,50,2163,1103,50,1153,0.956634866,0,1010,0,1010,1,1
95490,45,Mendocino,430.1207543,9,1,10,6,1,7,0.857142857,0,3,0,3,1,1
95494,45,Mendocino,124.652322,0,0,0,0,0,0,0,0,0,0,0,0,0
95528,23,Humboldt,87.88234338,0,0,0,0,0,0,0,0,0,0,0,0,0
95542,23,Humboldt,219.5353315,1,0,1,1,0,1,1,1,0,0,0,0,0
95519,23,Humboldt,53.76725927,6357,270,6627,5439,270,5709,0.952706253,0,918,0,918,1,1
95550,23,Humboldt,135.7491713,0,0,0,0,0,0,0,0,0,0,0,0,0
95562,23,Humboldt,16.58382536,5,1,6,5,1,6,0.833333333,0,0,0,0,0,0
95526,23,Humboldt,126.1645588,0,0,0,0,0,0,0,0,0,0,0,0,0
95570,23,Humboldt,52.38757967,185,13,198,153,13,166,0.921686747,0,32,0,32,1,1
95540,23,Humboldt,34.07411036,200,38,238,167,38,205,0.814634146,0,33,0,33,1,1
95524,23,Humboldt,8.124864945,545,24,569,485,24,509,0.952848723,0,60,0,60,1,1
95560,23,Humboldt,16.69007232,0,0,0,0,0,0,0,0,0,0,0,0,0
95521,23,Humboldt,60.37836457,33789,1042,34831,29201,1042,30243,0.965545746,0,4588,0,4588,1,1
95569,23,Humboldt,54.80680975,0,0,0,0,0,0,0,0,0,0,0,0,0
95589,23,Humboldt,152.7951181,0,0,0,0,0,0,0,0,0,0,0,0,0
95503,23,Humboldt,83.74433934,13171,403,13574,11635,403,12038,0.966522678,0,1536,0,1536,1,1
95501,23,Humboldt,7.336389838,30784,1061,31845,26841,1061,27902,0.961974052,0,3943,0,3943,1,1
95511,23,Humboldt,41.26463278,0,0,0,0,0,0,0,0,0,0,0,0,0
95514,23,Humboldt,102.8555499,0,0,0,0,0,0,0,0,0,0,0,0,0
95525,23,Humboldt,92.71648342,717,54,771,622,54,676,0.920118343,0,95,0,95,1,1
95536,23,Humboldt,162.7739633,13,2,15,12,2,14,0.857142857,0,1,0,1,1,1
95537,23,Humboldt,0.298290497,72,2,74,62,2,64,0.96875,0,10,0,10,1,1
95545,23,Humboldt,135.967063,0,0,0,0,0,0,0,0,0,0,0,0,0
95546,23,Humboldt,87.47426805,0,0,0,0,0,0,0,0,0,0,0,0,0
95547,23,Humboldt,10.39399205,4,0,4,4,0,4,1,1,0,0,0,0,0
95559,23,Humboldt,18.4004632,0,0,0,0,0,0,0,0,0,0,0,0,0
95571,23,Humboldt,6.578855182,0,0,0,0,0,0,0,0,0,0,0,0,0
95573,23,Humboldt,119.9864959,0,0,0,0,0,0,0,0,0,0,0,0,0
95549,23,Humboldt,138.7598955,51,6,57,46,6,52,0.884615385,0,5,0,5,1,1
95551,23,Humboldt,42.39212387,294,34,328,262,34,296,0.885135135,0,32,0,32,1,1
95553,23,Humboldt,70.15893994,0,0,0,0,0,0,0,0,0,0,0,0,0
95554,23,Humboldt,32.66681736,0,0,0,0,0,0,0,0,0,0,0,0,0
95555,23,Humboldt,111.2526549,1,0,1,1,0,1,1,1,0,0,0,0,0
95556,23,Humboldt,167.8429624,0,0,0,0,0,0,0,0,0,0,0,0,0
95558,23,Humboldt,168.4461874,0,0,0,0,0,0,0,0,0,0,0,0,0
95564,23,Humboldt,3.35569502,455,14,469,417,14,431,0.967517401,0,38,0,38,1,1
95565,23,Humboldt,33.68586031,2,0,2,1,0,1,1,1,1,0,1,1,1
95601,5,Amador,2.062719723,6,0,6,3,0,3,1,1,3,0,3,1,1
95685,5,Amador,39.97772202,284,7,291,172,7,179,0.960893855,0,112,0,112,1,1
95640,5,Amador,131.4006622,112,8,120,78,8,86,0.906976744,0,34,0,34,1,1
95689,5,Amador,25.26445276,0,0,0,0,0,0,0,0,0,0,0,0,0
95642,5,Amador,66.47756072,485,10,495,360,10,370,0.972972973,0,125,0,125,1,1
95665,5,Amador,20.25995009,43,1,44,35,1,36,0.972222222,0,8,0,8,1,1
95666,5,Amador,83.9751234,1,0,1,1,0,1,1,1,0,0,0,0,0
95669,5,Amador,75.72050509,138,8,146,89,8,97,0.917525773,0,49,0,49,1,1
95675,5,Amador,0.202480314,2,0,2,1,0,1,1,1,1,0,1,1,1
95699,5,Amador,3.491249984,5,0,5,2,0,2,1,1,3,0,3,1,1
95629,5,Amador,57.02890783,0,0,0,0,0,0,0,0,0,0,0,0,0
95619,17,El Dorado,5.936059847,1225,64,1289,538,64,602,0.893687708,0,687,0,687,1,1
95726,17,El Dorado,142.9549503,346,2,348,62,2,64,0.96875,0,284,0,284,1,1
95762,17,El Dorado,41.58782081,46660,953,47613,24644,953,25597,0.962769075,0,22016,0,22016,1,1
95684,17,El Dorado,159.8096083,9,4,13,7,4,11,0.636363636,0,2,0,2,1,1
96150,17,El Dorado,163.1756919,148237,2425,150662,103659,2425,106084,0.977140756,0,44578,0,44578,1,1
95636,17,El Dorado,11.46871815,0,0,0,0,0,0,0,0,0,0,0,0,0
95709,17,El Dorado,23.7946252,384,15,399,117,15,132,0.886363636,0,267,0,267,1,1
95651,17,El Dorado,13.36600656,69,8,77,38,8,46,0.826086957,0,31,0,31,1,1
95682,17,El Dorado,89.88299378,17101,608,17709,9263,608,9871,0.93840543,0,7838,0,7838,1,1
95614,17,El Dorado,31.75556541,129,17,146,79,17,96,0.822916667,0,50,0,50,1,1
95633,17,El Dorado,39.45984023,18,7,25,8,7,15,0.533333333,0,10,0,10,1,1
95635,17,El Dorado,29.54844083,33,15,48,28,15,43,0.651162791,0,5,0,5,1,1
95672,17,El Dorado,21.74511023,1600,57,1657,942,57,999,0.942942943,0,658,0,658,1,1
95664,17,El Dorado,36.74440693,51,7,58,31,7,38,0.815789474,0,20,0,20,1,1
95667,17,El Dorado,169.0806464,14609,841,15450,8227,841,9068,0.907256286,0,6382,0,6382,1,1
95720,17,El Dorado,155.8013492,5,2,7,3,2,5,0.6,0,2,0,2,1,1
95721,17,El Dorado,4.521001915,128,6,134,96,6,102,0.941176471,0,32,0,32,1,1
95735,17,El Dorado,43.77485794,14,1,15,11,1,12,0.916666667,0,3,0,3,1,1
95634,17,El Dorado,118.6116665,14,1,15,7,1,8,0.875,0,7,0,7,1,1
95623,17,El Dorado,44.65997219,632,50,682,389,50,439,0.886104784,0,243,0,243,1,1
96142,17,El Dorado,15.98599764,365,29,394,251,29,280,0.896428571,0,114,0,114,1,1
96155,17,El Dorado,37.73958865,104,4,108,90,4,94,0.957446809,0,14,0,14,1,1
95613,17,El Dorado,1.13028185,0,0,0,0,0,0,0,0,0,0,0,0,0
95970,11,Colusa,32.10219266,0,0,0,0,0,0,0,0,0,0,0,0,0
95955,11,Colusa,130.9338257,1,0,1,1,0,1,1,1,0,0,0,0,0
95912,11,Colusa,152.4103476,13,0,13,8,0,8,1,1,5,0,5,1,1
95950,11,Colusa,52.85762857,0,0,0,0,0,0,0,0,0,0,0,0,0
95932,11,Colusa,142.6405751,43,3,46,24,3,27,0.888888889,0,19,0,19,1,1
95979,11,Colusa,234.2085394,0,0,0,0,0,0,0,0,0,0,0,0,0
95987,11,Colusa,316.9766845,27,0,27,19,0,19,1,1,8,0,8,1,1
96111,57,Nevada,4.772670345,5,0,5,3,0,3,1,1,2,0,2,1,1
95975,57,Nevada,9.43857017,16,2,18,8,2,10,0.8,0,8,0,8,1,1
96161,57,Nevada,262.6441769,28861,771,29632,20847,771,21618,0.964335276,0,8014,0,8014,1,1
95960,57,Nevada,41.60118966,5,0,5,5,0,5,1,1,0,0,0,0,0
95945,57,Nevada,61.14292709,2235,142,2377,1523,142,1665,0.914714715,0,712,0,712,1,1
95946,57,Nevada,44.72093069,101,4,105,46,4,50,0.92,0,55,0,55,1,1
95949,57,Nevada,136.9390553,1063,69,1132,604,69,673,0.897473997,0,459,0,459,1,1
95959,57,Nevada,311.8996089,1029,68,1097,710,68,778,0.912596401,0,319,0,319,1,1
95986,57,Nevada,10.88298707,0,0,0,0,0,0,0,0,0,0,0,0,0
91320,111,Ventura,20.17613423,93680,5213,98893,55685,1759,57444,0.969378873,0,37995,3454,41449,0.916668677,0
91360,111,Ventura,15.36269747,117272,6657,123929,65021,2440,67461,0.963830954,0,52251,4217,56468,0.925320536,0
93022,111,Ventura,3.139123451,2104,313,2417,1226,122,1348,0.909495549,0,878,191,1069,0.821328344,0
93066,111,Ventura,42.08345258,2219,251,2470,1368,78,1446,0.946058091,0,851,173,1024,0.831054688,0
93015,111,Ventura,92.78867948,1809,424,2233,795,143,938,0.847547974,0,1014,281,1295,0.783011583,0
93023,111,Ventura,266.8694621,7200,1091,8291,4045,542,4587,0.881839983,0,3155,549,3704,0.851781857,0
91361,111,Ventura,28.86761038,76223,4445,80668,48677,1841,50518,0.963557544,0,27546,2604,30150,0.913631841,0
93065,111,Ventura,29.80235947,154982,7379,162361,80017,2187,82204,0.973395455,0,74965,5192,80157,0.935227117,0
93225,111,Ventura,112.0468563,26,14,40,7,1,8,0.875,0,19,13,32,0.59375,0
93012,111,Ventura,50.13807206,53270,3305,56575,30948,910,31858,0.971435746,0,22322,2395,24717,0.903103127,0
91362,111,Ventura,18.98921168,134227,6552,140779,83094,2498,85592,0.970815029,0,51133,4054,55187,0.926540671,0
91377,111,Ventura,5.394626098,17016,1108,18124,9524,339,9863,0.965629119,0,7492,769,8261,0.906911996,0
93035,111,Ventura,5.028810245,53350,2964,56314,29296,998,30294,0.967056183,0,24054,1966,26020,0.924442736,0
93003,111,Ventura,20.78504391,157366,7209,164575,89534,2547,92081,0.972339571,0,67832,4662,72494,0.93569123,0
93001,111,Ventura,96.58556945,149538,9322,158860,89026,3720,92746,0.959890453,0,60512,5602,66114,0.915267568,0
93004,111,Ventura,7.029140955,38034,2203,40237,20782,640,21422,0.970124171,0,17252,1563,18815,0.916927983,0
93010,111,Ventura,21.9724321,97594,6361,103955,54632,1962,56594,0.965332014,0,42962,4399,47361,0.907117671,0
93021,111,Ventura,47.79169943,46072,3405,49477,25306,839,26145,0.967909734,0,20766,2566,23332,0.890022287,0
93060,111,Ventura,92.44699552,10044,1376,11420,5349,336,5685,0.940897098,0,4695,1040,5735,0.818657367,0
93064,111,Ventura,6.614522318,136,8,144,102,4,106,0.962264151,0,34,4,38,0.894736842,0
93030,111,Ventura,14.11286467,131563,6906,138469,68239,1973,70212,0.97189939,0,63324,4933,68257,0.927729024,0
93033,111,Ventura,32.19565572,97274,5449,102723,49771,1534,51305,0.97010038,0,47503,3915,51418,0.923859349,0
93036,111,Ventura,17.79916401,140822,7427,148249,72494,2237,74731,0.97006597,0,68328,5190,73518,0.929405044,0
93040,111,Ventura,372.1206808,217,61,278,58,6,64,0.90625,0,159,55,214,0.742990654,0
93041,111,Ventura,5.879139225,37533,2058,39591,18705,522,19227,0.972850679,0,18828,1536,20364,0.924572775,0
93043,111,Ventura,0.495339485,4896,109,5005,3210,32,3242,0.99012955,0,1686,77,1763,0.956324447,0
93063,111,Ventura,36.16678519,96305,5763,102068,50176,1431,51607,0.972271204,0,46129,4332,50461,0.914151523,0
93252,111,Ventura,446.5446087,3,2,5,3,2,5,0.6,0,0,0,0,0,0
93224,29,Kern,35.59377894,0,0,0,0,0,0,0,0,0,0,0,0,0
93251,29,Kern,107.1636177,1,0,1,1,0,1,1,1,0,0,0,0,0
93263,29,Kern,92.24721677,1583,86,1669,631,86,717,0.880055788,0,952,0,952,1,1
93222,29,Kern,108.5105885,4,0,4,1,0,1,1,1,3,0,3,1,1
93203,29,Kern,172.0265004,803,58,861,282,47,329,0.857142857,0,521,11,532,0.979323308,0
93243,29,Kern,163.4078003,279,66,345,158,29,187,0.844919786,0,121,37,158,0.765822785,0
93314,29,Kern,88.93788668,34900,1078,35978,21159,1078,22237,0.951522238,0,13741,0,13741,1,1
93555,29,Kern,78.08798487,3613,95,3708,1780,95,1875,0.949333333,0,1833,0,1833,1,1
93205,29,Kern,23.20730645,23,1,24,21,1,22,0.954545455,0,2,0,2,1,1
93255,29,Kern,237.9578864,2,0,2,2,0,2,1,1,0,0,0,0,0
93283,29,Kern,261.1124349,3,0,3,1,0,1,1,1,2,0,2,1,1
93554,29,Kern,135.0703096,0,0,0,0,0,0,0,0,0,0,0,0,0
93249,29,Kern,203.2456244,14,0,14,9,0,9,1,1,5,0,5,1,1
93311,29,Kern,212.9150489,101866,2426,104292,55795,2426,58221,0.958331186,0,46071,0,46071,1,1
93309,29,Kern,10.45168719,217203,5687,222890,110699,5687,116386,0.951136735,0,106504,0,106504,1,1
93528,29,Kern,2.453496432,0,0,0,0,0,0,0,0,0,0,0,0,0
93276,29,Kern,4.265091746,5,0,5,4,0,4,1,1,1,0,1,1,1
93304,29,Kern,7.473805438,175108,5257,180365,85162,5257,90419,0.941859565,0,89946,0,89946,1,1
93301,29,Kern,4.2854792,216480,7977,224457,132283,7977,140260,0.94312705,0,84197,0,84197,1,1
93305,29,Kern,5.785618254,136070,5607,141677,73977,5607,79584,0.92954614,0,62093,0,62093,1,1
93306,29,Kern,97.34327245,124110,3889,127999,65277,3889,69166,0.943772952,0,58833,0,58833,1,1
93307,29,Kern,141.2043633,156053,6388,162441,87403,6386,93789,0.931910992,0,68650,2,68652,0.999970868,0
93308,29,Kern,344.6005057,185054,6630,191684,98410,6630,105040,0.936881188,0,86644,0,86644,1,1
93312,29,Kern,14.17170732,125771,3462,129233,72851,3462,76313,0.954634204,0,52920,0,52920,1,1
93313,29,Kern,100.5619295,111762,2437,114199,55496,2437,57933,0.957934165,0,56266,0,56266,1,1
93516,29,Kern,28.5706365,2,1,3,2,1,3,0.666666667,0,0,0,0,0,0
93561,29,Kern,301.8236739,239,16,255,96,6,102,0.941176471,0,143,10,153,0.934640523,0
93501,29,Kern,222.0110139,383,50,433,121,17,138,0.876811594,0,262,33,295,0.888135593,0
93505,29,Kern,65.00211843,47,3,50,47,3,50,0.94,0,0,0,0,0,0
93518,29,Kern,324.310314,0,0,0,0,0,0,0,0,0,0,0,0,0
93519,29,Kern,137.3071743,0,0,0,0,0,0,0,0,0,0,0,0,0
93523,29,Kern,37.85228162,2,0,2,1,0,1,1,1,1,0,1,1,1
93524,29,Kern,72.44017488,0,0,0,0,0,0,0,0,0,0,0,0,0
93531,29,Kern,19.49321418,3,0,3,2,0,2,1,1,1,0,1,1,1
93560,29,Kern,167.9339856,3886,682,4568,1063,85,1148,0.925958188,0,2823,597,3420,0.825438596,0
93220,29,Kern,27.44132802,224,21,245,209,21,230,0.908695652,0,15,0,15,1,1
93206,29,Kern,163.8503686,99,13,112,51,13,64,0.796875,0,48,0,48,1,1
93215,29,Kern,145.4734929,424,26,450,119,26,145,0.820689655,0,305,0,305,1,1
93226,29,Kern,75.9556,0,0,0,0,0,0,0,0,0,0,0,0,0
93240,29,Kern,57.95204948,89,7,96,77,7,84,0.916666667,0,12,0,12,1,1
93241,29,Kern,5.048278385,4091,367,4458,2807,367,3174,0.884373031,0,1284,0,1284,1,1
93280,29,Kern,315.980383,210,21,231,89,21,110,0.809090909,0,121,0,121,1,1
93287,29,Kern,71.78613388,0,0,0,0,0,0,0,0,0,0,0,0,0
93250,29,Kern,89.57433369,135,3,138,43,3,46,0.934782609,0,92,0,92,1,1
93268,29,Kern,68.12039883,37,5,42,20,5,25,0.8,0,17,0,17,1,1
93285,29,Kern,54.39816723,57,1,58,51,1,52,0.980769231,0,6,0,6,1,1
93581,29,Kern,2.596352238,0,0,0,0,0,0,0,0,0,0,0,0,0
93522,27,Inyo,49.09328871,0,0,0,0,0,0,0,0,0,0,0,0,0
93527,27,Inyo,350.2192996,26,1,27,9,1,10,0.9,0,17,0,17,1,1
93549,27,Inyo,494.4889142,0,0,0,0,0,0,0,0,0,0,0,0,0
93526,27,Inyo,53.51871211,1,0,1,1,0,1,1,1,0,0,0,0,0
93530,27,Inyo,1.153365468,0,0,0,0,0,0,0,0,0,0,0,0,0
93513,27,Inyo,396.7614176,0,0,0,0,0,0,0,0,0,0,0,0,0
93545,27,Inyo,391.1225695,0,0,0,0,0,0,0,0,0,0,0,0,0
92328,27,Inyo,1773.564244,0,0,0,0,0,0,0,0,0,0,0,0,0
92384,27,Inyo,231.8681031,0,0,0,0,0,0,0,0,0,0,0,0,0
92389,27,Inyo,44.68991881,0,0,0,0,0,0,0,0,0,0,0,0,0
93541,51,Mono,317.3603345,0,0,0,0,0,0,0,0,0,0,0,0,0
93546,51,Mono,235.3506708,3046,154,3200,2395,154,2549,0.939584151,0,651,0,651,1,1
93517,51,Mono,337.4313237,1,0,1,1,0,1,1,1,0,0,0,0,0
93514,51,Mono,1007.102884,31,1,32,25,1,26,0.961538462,0,6,0,6,1,1
93512,51,Mono,100.8240358,0,0,0,0,0,0,0,0,0,0,0,0,0
93529,51,Mono,74.93570762,0,0,0,0,0,0,0,0,0,0,0,0,0
96107,51,Mono,95.73325127,0,0,0,0,0,0,0,0,0,0,0,0,0
96133,51,Mono,13.04979312,0,0,0,0,0,0,0,0,0,0,0,0,0
93901,53,Monterey,9.585835671,65217,1224,66441,40825,1224,42049,0.970891103,0,24392,0,24392,1,1
93933,53,Monterey,10.67445573,44649,450,45099,27314,450,27764,0.983791961,0,17335,0,17335,1,1
93954,53,Monterey,59.67733818,37,0,37,1,0,1,1,1,36,0,36,1,1
93450,53,Monterey,180.7281377,2,0,2,1,0,1,1,1,1,0,1,1,1
93907,53,Monterey,54.5262812,23171,349,23520,13750,349,14099,0.975246471,0,9421,0,9421,1,1
93953,53,Monterey,8.098667397,23016,405,23421,18861,405,19266,0.978978511,0,4155,0,4155,1,1
93426,53,Monterey,216.7654633,19,0,19,4,0,4,1,1,15,0,15,1,1
93923,53,Monterey,202.7237206,30905,496,31401,23465,496,23961,0.979299695,0,7440,0,7440,1,1
93960,53,Monterey,174.1297835,1185,36,1221,127,36,163,0.779141104,0,1058,0,1058,1,1
93921,53,Monterey,0.951998678,40730,624,41354,32234,624,32858,0.981009191,0,8496,0,8496,1,1
93950,53,Monterey,2.807916809,41206,398,41604,29816,398,30214,0.986827299,0,11390,0,11390,1,1
93451,53,Monterey,447.2254055,635,6,641,323,6,329,0.981762918,0,312,0,312,1,1
93925,53,Monterey,49.92826233,354,6,360,96,6,102,0.941176471,0,258,0,258,1,1
93927,53,Monterey,210.117655,975,24,999,62,24,86,0.720930233,0,913,0,913,1,1
93928,53,Monterey,38.39877873,0,0,0,0,0,0,0,0,0,0,0,0,0
93955,53,Monterey,26.30361598,86261,907,87168,59713,907,60620,0.985037941,0,26548,0,26548,1,1
93926,53,Monterey,67.15630196,667,28,695,113,28,141,0.80141844,0,554,0,554,1,1
93930,53,Monterey,343.2546002,384,12,396,41,12,53,0.773584906,0,343,0,343,1,1
93932,53,Monterey,75.87809115,0,0,0,0,0,0,0,0,0,0,0,0,0
93905,53,Monterey,9.239922325,40954,630,41584,26674,630,27304,0.976926458,0,14280,0,14280,1,1
93906,53,Monterey,13.26045613,70475,954,71429,45249,954,46203,0.97935199,0,25226,0,25226,1,1
93908,53,Monterey,240.9510425,6061,202,6263,4335,202,4537,0.955477188,0,1726,0,1726,1,1
93920,53,Monterey,158.4896807,11,0,11,6,0,6,1,1,5,0,5,1,1
93924,53,Monterey,187.0074309,4165,184,4349,3048,184,3232,0.943069307,0,1117,0,1117,1,1
93940,53,Monterey,35.14241092,308390,3357,311747,226206,3357,229563,0.985376563,0,82184,0,82184,1,1
93943,53,Monterey,0.203049432,1212,10,1222,975,10,985,0.989847716,0,237,0,237,1,1
93962,53,Monterey,0.12215445,443,9,452,291,9,300,0.97,0,152,0,152,1,1
95039,53,Monterey,17.38532801,1110,45,1155,678,45,723,0.937759336,0,432,0,432,1,1
95012,53,Monterey,12.91392155,4548,127,4675,2717,127,2844,0.955344585,0,1831,0,1831,1,1
93944,53,Monterey,0.336982373,0,0,0,0,0,0,0,0,0,0,0,0,0
94115,75,San Francisco,1.13638075,1886186,42895,1929081,1172705,14983,1187688,0.987384734,0,713481,27912,741393,0.962351951,0
94109,75,San Francisco,1.078681356,3281227,88779,3370006,2051069,32371,2083440,0.984462716,0,1230158,56408,1286566,0.956156155,0
94110,75,San Francisco,2.389857986,2941968,76645,3018613,1640849,23600,1664449,0.985821134,0,1301119,53045,1354164,0.960828231,0
94107,75,San Francisco,1.855766393,2457852,88157,2546009,1427004,25473,1452477,0.982462373,0,1030848,62684,1093532,0.942677489,0
94117,75,San Francisco,1.274552341,1875578,44796,1920374,1083010,12361,1095371,0.988715239,0,792568,32435,825003,0.960684991,0
94112,75,San Francisco,3.335411428,1127947,25273,1153220,771559,9639,781198,0.987661259,0,356388,15634,372022,0.957975604,0
94134,75,San Francisco,2.558899371,399221,10269,409490,259934,3181,263115,0.987910229,0,139287,7088,146375,0.95157643,0
94105,75,San Francisco,0.504523357,2000301,89366,2089667,1258550,31147,1289697,0.975849366,0,741751,58219,799970,0.927223521,0
94132,75,San Francisco,3.131990178,693315,15275,708590,513646,6670,520316,0.987180867,0,179669,8605,188274,0.954295336,0
94102,75,San Francisco,0.661505167,2833210,102515,2935725,1755812,37132,1792944,0.979289928,0,1077398,65383,1142781,0.942786063,0
94103,75,San Francisco,1.373883793,4063503,152359,4215862,2465127,51395,2516522,0.979576972,0,1598376,100964,1699340,0.940586345,0
94111,75,San Francisco,0.333612456,1342792,48360,1391152,861511,18476,879987,0.979004235,0,481281,29884,511165,0.941537468,0
94158,75,San Francisco,0.610883447,799403,41792,841195,476362,16505,492867,0.966512264,0,323041,25287,348328,0.92740463,0
94114,75,San Francisco,1.384659185,1555588,41631,1597219,871388,12204,883592,0.986188195,0,684200,29427,713627,0.958764172,0
94121,75,San Francisco,2.534590644,756731,21346,778077,463579,5183,468762,0.988943216,0,293152,16163,309315,0.947745825,0
94123,75,San Francisco,1.082710352,1843016,52861,1895877,1177352,20263,1197615,0.983080539,0,665664,32598,698262,0.953315518,0
94131,75,San Francisco,2.022059875,637171,17776,654947,363375,4127,367502,0.988770129,0,273796,13649,287445,0.952516134,0
94104,75,San Francisco,0.077551707,595064,26928,621992,375557,8946,384503,0.976733602,0,219507,17982,237489,0.924282809,0
94108,75,San Francisco,0.257976212,1326134,45792,1371926,874919,17117,892036,0.980811313,0,451215,28675,479890,0.940246723,0
94118,75,San Francisco,2.005271297,1331766,31827,1363593,828017,9414,837431,0.988758477,0,503749,22413,526162,0.957402853,0
94116,75,San Francisco,2.526099057,519488,11556,531044,345384,3606,348990,0.989667326,0,174104,7950,182054,0.956331638,0
94122,75,San Francisco,3.257229986,1011372,24281,1035653,621537,6225,627762,0.990083822,0,389835,18056,407891,0.955733272,0
94124,75,San Francisco,4.772884632,655608,21943,677551,405637,6581,412218,0.984035146,0,249971,15362,265333,0.942102942,0
94127,75,San Francisco,1.864960303,288878,6747,295625,186319,2080,188399,0.988959602,0,102559,4667,107226,0.956475109,0
94129,75,San Francisco,2.349138292,323531,12944,336475,202645,2587,205232,0.987394753,0,120886,10357,131243,0.921085315,0
94130,75,San Francisco,0.88080765,31648,3972,35620,16049,625,16674,0.962516493,0,15599,3347,18946,0.823340019,0
94133,75,San Francisco,0.657581191,1948709,59705,2008414,1263936,22924,1286860,0.982186096,0,684773,36781,721554,0.949025298,0
94188,75,San Francisco,0.087115505,0,0,0,0,0,0,0,0,0,0,0,0,0
95023,69,San Benito,394.8303485,9915,519,10434,8490,519,9009,0.942390942,0,1425,0,1425,1,1
95075,69,San Benito,91.95015254,12,2,14,12,2,14,0.857142857,0,0,0,0,0,0
95045,69,San Benito,47.32758303,1054,52,1106,687,52,739,0.929634641,0,367,0,367,1,1
95004,69,San Benito,21.95737404,668,64,732,451,64,515,0.875728155,0,217,0,217,1,1
95043,69,San Benito,765.0145769,1,0,1,1,0,1,1,1,0,0,0,0,0
95374,47,Merced,44.45245862,184,16,200,33,16,49,0.673469388,0,151,0,151,1,1
93635,47,Merced,390.7374569,2596,118,2714,552,118,670,0.823880597,0,2044,0,2044,1,1
95334,47,Merced,56.47316352,3123,151,3274,1027,151,1178,0.871816638,0,2096,0,2096,1,1
95340,47,Merced,51.95667439,73433,1029,74462,33957,1029,34986,0.970588235,0,39476,0,39476,1,1
95341,47,Merced,146.8263471,25685,497,26182,9910,497,10407,0.952243682,0,15775,0,15775,1,1
95388,47,Merced,37.69645773,2302,97,2399,685,97,782,0.875959079,0,1617,0,1617,1,1
95317,47,Merced,46.18787753,14,2,16,7,2,9,0.777777778,0,7,0,7,1,1
93620,47,Merced,161.2707493,324,18,342,28,18,46,0.608695652,0,296,0,296,1,1
93665,47,Merced,0.523303459,11,0,11,1,0,1,1,1,10,0,10,1,1
95365,47,Merced,3.665425009,568,20,588,124,20,144,0.861111111,0,444,0,444,1,1
95303,47,Merced,28.89239247,60,5,65,31,5,36,0.861111111,0,29,0,29,1,1
95315,47,Merced,18.94220274,3013,127,3140,1019,127,1146,0.889179756,0,1994,0,1994,1,1
95322,47,Merced,169.3921583,445,29,474,115,29,144,0.798611111,0,330,0,330,1,1
95301,47,Merced,76.06392652,15542,594,16136,5635,594,6229,0.904639589,0,9907,0,9907,1,1
95312,47,Merced,0.980165356,52,2,54,6,2,8,0.75,0,46,0,46,1,1
95324,47,Merced,40.1564021,1266,79,1345,439,79,518,0.847490347,0,827,0,827,1,1
95333,47,Merced,122.3251422,125,6,131,30,6,36,0.833333333,0,95,0,95,1,1
95348,47,Merced,58.995083,58124,662,58786,27057,662,27719,0.976117465,0,31067,0,31067,1,1
95369,47,Merced,156.0925535,27,1,28,4,1,5,0.8,0,23,0,23,1,1
95694,113,Yolo,133.3157847,2007,99,2106,697,99,796,0.875628141,0,1310,0,1310,1,1
95606,113,Yolo,37.96689739,83,3,86,42,3,45,0.933333333,0,41,0,41,1,1
95695,113,Yolo,145.6132128,37557,943,38500,16428,943,17371,0.945714121,0,21129,0,21129,1,1
95937,113,Yolo,53.20507668,112,5,117,44,5,49,0.897959184,0,68,0,68,1,1
95607,113,Yolo,132.7494963,3,1,4,3,1,4,0.75,0,0,0,0,0,0
95605,113,Yolo,3.899246163,90694,1092,91786,41896,1092,42988,0.974597562,0,48798,0,48798,1,1
95612,113,Yolo,63.60780433,2578,51,2629,1260,51,1311,0.961098398,0,1318,0,1318,1,1
95616,113,Yolo,29.85513952,352008,2712,354720,142051,2712,144763,0.981265931,0,209957,0,209957,1,1
95627,113,Yolo,52.31951107,99,7,106,42,7,49,0.857142857,0,57,0,57,1,1
95637,113,Yolo,42.48638616,0,0,0,0,0,0,0,0,0,0,0,0,0
95653,113,Yolo,5.492654063,27,2,29,15,2,17,0.882352941,0,12,0,12,1,1
95679,113,Yolo,5.90739741,0,0,0,0,0,0,0,0,0,0,0,0,0
95691,113,Yolo,39.02864383,155175,2024,157199,71459,2024,73483,0.972456214,0,83716,0,83716,1,1
95697,113,Yolo,0.274042775,132,2,134,72,2,74,0.972972973,0,60,0,60,1,1
95698,113,Yolo,38.39052151,39,3,42,21,3,24,0.875,0,18,0,18,1,1
95776,113,Yolo,88.20266189,36487,681,37168,15894,681,16575,0.958914027,0,20593,0,20593,1,1
95618,113,Yolo,32.13034544,108685,1028,109713,45978,1028,47006,0.978130451,0,62707,0,62707,1,1
94599,55,Napa,7.945282919,37556,505,38061,29602,505,30107,0.983226492,0,7954,0,7954,1,1
94558,55,Napa,399.8542773,223480,2843,226323,167699,2843,170542,0.98332962,0,55781,0,55781,1,1
94573,55,Napa,1.536388049,1470,14,1484,1116,14,1130,0.987610619,0,354,0,354,1,1
94503,55,Napa,27.03338705,32636,495,33131,20349,495,20844,0.976252159,0,12287,0,12287,1,1
94559,55,Napa,41.3664407,215906,3390,219296,157259,3390,160649,0.978898095,0,58647,0,58647,1,1
94567,55,Napa,72.30441914,3,0,3,3,0,3,1,1,0,0,0,0,0
94574,55,Napa,124.2953305,58554,1164,59718,45320,1164,46484,0.974959126,0,13234,0,13234,1,1
94576,55,Napa,0.284072214,112,6,118,78,6,84,0.928571429,0,34,0,34,1,1
94508,55,Napa,16.01299481,837,51,888,604,51,655,0.922137405,0,233,0,233,1,1
94515,55,Napa,115.5307359,20021,612,20633,14796,612,15408,0.960280374,0,5225,0,5225,1,1
94562,55,Napa,0.278261348,0,0,0,0,0,0,0,0,0,0,0,0,0
95245,9,Calaveras,69.81007019,6,0,6,6,0,6,1,1,0,0,0,0,0
95228,9,Calaveras,91.40497397,3,0,3,1,0,1,1,1,2,0,2,1,1
95249,9,Calaveras,81.22851219,29,0,29,25,0,25,1,1,4,0,4,1,1
95225,9,Calaveras,9.687569462,32,0,32,1,0,1,1,1,31,0,31,1,1
95222,9,Calaveras,151.7990472,48,2,50,38,2,40,0.95,0,10,0,10,1,1
95224,9,Calaveras,11.52403413,1,0,1,1,0,1,1,1,0,0,0,0,0
95226,9,Calaveras,3.85587432,0,0,0,0,0,0,0,0,0,0,0,0,0
95232,9,Calaveras,4.950692124,0,0,0,0,0,0,0,0,0,0,0,0,0
95252,9,Calaveras,114.0008862,28,0,28,15,0,15,1,1,13,0,13,1,1
95233,9,Calaveras,1.610589531,0,0,0,0,0,0,0,0,0,0,0,0,0
95251,9,Calaveras,12.21720485,4,0,4,4,0,4,1,1,0,0,0,0,0
95247,9,Calaveras,47.02514191,60,1,61,53,1,54,0.981481481,0,7,0,7,1,1
95246,9,Calaveras,69.07388594,0,0,0,0,0,0,0,0,0,0,0,0,0
95248,9,Calaveras,31.58222746,0,0,0,0,0,0,0,0,0,0,0,0,0
95254,9,Calaveras,4.876417669,0,0,0,0,0,0,0,0,0,0,0,0,0
95255,9,Calaveras,44.12894472,0,0,0,0,0,0,0,0,0,0,0,0,0
95257,9,Calaveras,11.76195416,0,0,0,0,0,0,0,0,0,0,0,0,0
95221,9,Calaveras,0.231560901,0,0,0,0,0,0,0,0,0,0,0,0,0
95305,109,Tuolumne,58.26383084,0,0,0,0,0,0,0,0,0,0,0,0,0
95364,109,Tuolumne,197.0758191,0,0,0,0,0,0,0,0,0,0,0,0,0
95370,109,Tuolumne,103.0965348,825,27,852,647,27,674,0.959940653,0,178,0,178,1,1
95372,109,Tuolumne,2.420116576,8,0,8,6,0,6,1,1,2,0,2,1,1
95375,109,Tuolumne,13.94689513,0,0,0,0,0,0,0,0,0,0,0,0,0
95379,109,Tuolumne,25.88534364,141,6,147,109,6,115,0.947826087,0,32,0,32,1,1
95383,109,Tuolumne,66.22246601,72,4,76,70,4,74,0.945945946,0,2,0,2,1,1
95346,109,Tuolumne,5.108546143,5,1,6,4,1,5,0.8,0,1,0,1,1,1
95321,109,Tuolumne,449.0973029,4,0,4,2,0,2,1,1,2,0,2,1,1
95310,109,Tuolumne,44.72919177,21,0,21,19,0,19,1,1,2,0,2,1,1
95327,109,Tuolumne,158.7654343,178,11,189,122,11,133,0.917293233,0,56,0,56,1,1
95329,109,Tuolumne,116.5705022,0,0,0,0,0,0,0,0,0,0,0,0,0
95335,109,Tuolumne,41.0644548,1,0,1,1,0,1,1,1,0,0,0,0,0
95309,109,Tuolumne,0.018355388,0,0,0,0,0,0,0,0,0,0,0,0,0
95368,99,Stanislaus,3.060667103,16375,367,16742,5709,367,6076,0.93959842,0,10666,0,10666,1,1
95380,99,Stanislaus,77.15557943,45968,1723,47691,18179,1723,19902,0.913425786,0,27789,0,27789,1,1
95350,99,Stanislaus,8.835691047,141866,2779,144645,52206,2779,54985,0.949458943,0,89660,0,89660,1,1
95313,99,Stanislaus,45.7376269,166,13,179,71,13,84,0.845238095,0,95,0,95,1,1
95357,99,Stanislaus,39.34940752,14771,379,15150,5594,379,5973,0.936547798,0,9177,0,9177,1,1
95363,99,Stanislaus,478.3131939,1912,159,2071,717,159,876,0.818493151,0,1195,0,1195,1,1
95323,99,Stanislaus,31.31088664,79,2,81,22,2,24,0.916666667,0,57,0,57,1,1
95358,99,Stanislaus,116.2670484,31788,861,32649,12525,861,13386,0.935679068,0,19263,0,19263,1,1
95354,99,Stanislaus,7.654239596,86570,2462,89032,33968,2462,36430,0.932418337,0,52602,0,52602,1,1
95355,99,Stanislaus,9.34617585,95324,2102,97426,37354,2102,39456,0.946725466,0,57970,0,57970,1,1
95386,99,Stanislaus,94.68444394,1120,55,1175,337,55,392,0.859693878,0,783,0,783,1,1
95351,99,Stanislaus,8.89246379,64516,1633,66149,23462,1633,25095,0.934927276,0,41054,0,41054,1,1
95360,99,Stanislaus,61.81394084,337,29,366,109,29,138,0.789855072,0,228,0,228,1,1
95361,99,Stanislaus,217.4133915,8007,484,8491,3172,484,3656,0.86761488,0,4835,0,4835,1,1
95356,99,Stanislaus,22.21168419,80182,1769,81951,31433,1769,33202,0.946720077,0,48749,0,48749,1,1
95367,99,Stanislaus,5.252163346,18800,530,19330,7724,530,8254,0.935788709,0,11076,0,11076,1,1
95385,99,Stanislaus,26.84557715,110,1,111,53,1,54,0.981481481,0,57,0,57,1,1
95230,99,Stanislaus,136.8788022,17,2,19,8,2,10,0.8,0,9,0,9,1,1
95382,99,Stanislaus,10.94528303,30650,924,31574,12247,924,13171,0.929845874,0,18403,0,18403,1,1
95387,99,Stanislaus,21.52202625,145,15,160,53,15,68,0.779411765,0,92,0,92,1,1
95326,99,Stanislaus,26.50114374,3546,184,3730,1671,184,1855,0.900808625,0,1875,0,1875,1,1
95307,99,Stanislaus,32.83450391,44887,1400,46287,18381,1400,19781,0.929225014,0,26506,0,26506,1,1
95316,99,Stanislaus,81.80155396,2743,107,2850,1218,107,1325,0.919245283,0,1525,0,1525,1,1
95319,99,Stanislaus,2.525495962,1649,60,1709,707,60,767,0.921773142,0,942,0,942,1,1
95328,99,Stanislaus,0.902007466,2278,53,2331,848,53,901,0.941176471,0,1430,0,1430,1,1
96024,105,Trinity,104.6364418,0,0,0,0,0,0,0,0,0,0,0,0,0
95552,105,Trinity,136.8894571,0,0,0,0,0,0,0,0,0,0,0,0,0
96041,105,Trinity,335.5437782,0,0,0,0,0,0,0,0,0,0,0,0,0
95563,105,Trinity,66.07412791,0,0,0,0,0,0,0,0,0,0,0,0,0
95527,105,Trinity,143.6962732,0,0,0,0,0,0,0,0,0,0,0,0,0
95595,105,Trinity,552.7665988,0,0,0,0,0,0,0,0,0,0,0,0,0
96091,105,Trinity,425.4574286,0,0,0,0,0,0,0,0,0,0,0,0,0
96093,105,Trinity,99.60098709,3,0,3,2,0,2,1,1,1,0,1,1,1
96052,105,Trinity,111.1709356,0,0,0,0,0,0,0,0,0,0,0,0,0
96010,105,Trinity,383.8469138,0,0,0,0,0,0,0,0,0,0,0,0,0
96046,105,Trinity,141.1689316,0,0,0,0,0,0,0,0,0,0,0,0,0
96048,105,Trinity,155.4165582,0,0,0,0,0,0,0,0,0,0,0,0,0
96129,63,Plumas,116.0011091,2,0,2,2,0,2,1,1,0,0,0,0,0
96103,63,Plumas,97.27761893,22,0,22,22,0,22,1,1,0,0,0,0,0
96122,63,Plumas,64.03187054,13,1,14,10,1,11,0.909090909,0,3,0,3,1,1
95915,63,Plumas,36.20760141,0,0,0,0,0,0,0,0,0,0,0,0,0
96106,63,Plumas,22.06008506,6,0,6,6,0,6,1,1,0,0,0,0,0
96135,63,Plumas,34.8261021,0,0,0,0,0,0,0,0,0,0,0,0,0
96105,63,Plumas,254.081619,0,0,0,0,0,0,0,0,0,0,0,0,0
96137,63,Plumas,142.1910642,0,0,0,0,0,0,0,0,0,0,0,0,0
95947,63,Plumas,85.41507886,0,0,0,0,0,0,0,0,0,0,0,0,0
95971,63,Plumas,150.8422709,3,0,3,3,0,3,1,1,0,0,0,0,0
95981,63,Plumas,53.08857325,0,0,0,0,0,0,0,0,0,0,0,0,0
95984,63,Plumas,75.56835537,0,0,0,0,0,0,0,0,0,0,0,0,0
95923,63,Plumas,10.1596871,0,0,0,0,0,0,0,0,0,0,0,0,0
95934,63,Plumas,21.54220829,0,0,0,0,0,0,0,0,0,0,0,0,0
95956,63,Plumas,59.20751592,0,0,0,0,0,0,0,0,0,0,0,0,0
95983,63,Plumas,85.32964407,0,0,0,0,0,0,0,0,0,0,0,0,0
96020,63,Plumas,56.30628239,0,0,0,0,0,0,0,0,0,0,0,0,0
95493,33,Lake,7.856987866,0,0,0,0,0,0,0,0,0,0,0,0,0
95426,33,Lake,28.65803232,1,0,1,0,0,0,0,0,1,0,1,1,1
95451,33,Lake,92.86215856,6,0,6,2,0,2,1,1,4,0,4,1,1
95422,33,Lake,26.88379412,113,4,117,32,4,36,0.888888889,0,81,0,81,1,1
95423,33,Lake,122.4344795,9,0,9,0,0,0,0,0,9,0,9,1,1
95435,33,Lake,0.014293187,0,0,0,0,0,0,0,0,0,0,0,0,0
95443,33,Lake,4.171727919,0,0,0,0,0,0,0,0,0,0,0,0,0
95467,33,Lake,7.355949871,4,0,4,1,0,1,1,1,3,0,3,1,1
95457,33,Lake,147.9296372,10,1,11,5,1,6,0.833333333,0,5,0,5,1,1
95464,33,Lake,2.536722324,3,0,3,1,0,1,1,1,2,0,2,1,1
95453,33,Lake,87.02851089,8,1,9,1,1,2,0.5,0,7,0,7,1,1
95458,33,Lake,34.88784053,3,0,3,2,0,2,1,1,1,0,1,1,1
95461,33,Lake,123.2866294,11,0,11,4,0,4,1,1,7,0,7,1,1
95485,33,Lake,86.98480584,6,0,6,4,0,4,1,1,2,0,2,1,1
95223,3,Alpine,426.7888167,4,0,4,4,0,4,1,1,0,0,0,0,0
95646,3,Alpine,53.38625331,1,0,1,0,0,0,0,0,1,0,1,1,1
96120,3,Alpine,226.4708249,3,0,3,3,0,3,1,1,0,0,0,0,0
95567,15,Del Norte,62.50293044,7,0,7,7,0,7,1,1,0,0,0,0,0
95543,15,Del Norte,141.2444158,0,0,0,0,0,0,0,0,0,0,0,0,0
95531,15,Del Norte,189.4057952,192,13,205,187,13,200,0.935,0,5,0,5,1,1
95548,15,Del Norte,55.84321078,1,0,1,1,0,1,1,1,0,0,0,0,0
95538,15,Del Norte,1.891776389,0,0,0,0,0,0,0,0,0,0,0,0,0
95910,91,Sierra,32.9251237,0,0,0,0,0,0,0,0,0,0,0,0,0
96118,91,Sierra,170.7127126,0,0,0,0,0,0,0,0,0,0,0,0,0
96124,91,Sierra,53.10870162,0,0,0,0,0,0,0,0,0,0,0,0,0
96125,91,Sierra,92.76740824,0,0,0,0,0,0,0,0,0,0,0,0,0
96126,91,Sierra,28.72509358,0,0,0,0,0,0,0,0,0,0,0,0,0
95936,91,Sierra,43.93046251,0,0,0,0,0,0,0,0,0,0,0,0,0
95944,91,Sierra,9.406404612,0,0,0,0,0,0,0,0,0,0,0,0,0
95234,0,0,0,8,1,9,7,1,8,0.875,0,1,0,1,1,1
90090,0,0,0,18250,2007,20257,12617,966,13583,0.92888169,0,5633,1041,6674,0.844021576,0
94850,0,0,0,338,22,360,239,14,253,0.944664032,0,99,8,107,0.925233645,0
95724,0,0,0,50,0,50,30,0,30,1,1,20,0,20,1,1
0,0,0,0,52864,3890,56754,35482,2171,37653,0.942341912,0,17382,1719,19101,0.910004712,0
